AAAACACCCTGGTGGAATCA -> AAACACCCTGGTGGAATCAT
AAAACCCCTCTTGCTCAATG -> AAACCCCTCTTGCTCAATGA
AAACACCCTGGTGGAATCAT -> AACACCCTGGTGGAATCATT
AAACCCCTCTTGCTCAATGA -> AACCCCTCTTGCTCAATGAG
AAACGGAGGCTCTAGCGAAC -> AACGGAGGCTCTAGCGAACC
AAACTAGGTCGGACCGCCCT -> AACTAGGTCGGACCGCCCTA
AAACTTGCTGAACATTATTA -> AACTTGCTGAACATTATTAG
AAAGCCCGGATAATTTGAAT -> AAGCCCGGATAATTTGAATT
AAAGGCCAGGCTATGGCTGC -> AAGGCCAGGCTATGGCTGCA
AAATACGTGCGCACGTCAGC -> AATACGTGCGCACGTCAGCC
AAATGTCCACCAAATTATAG -> AATGTCCACCAAATTATAGA
AAATTATAGATTGAGCGACA -> AATTATAGATTGAGCGACAA
AACAAAGCCCGGATAATTTG -> ACAAAGCCCGGATAATTTGA
AACACCCTGGTGGAATCATT -> ACACCCTGGTGGAATCATTA
AACATTATTAGGCGAGATCA -> ACATTATTAGGCGAGATCAA
AACCACTGTTCAAGTTCGCT -> ACCACTGTTCAAGTTCGCTG
AACCCCTCTTGCTCAATGAG -> ACCCCTCTTGCTCAATGAGT
AACCTGGCCCTGCGCATGAA -> ACCTGGCCCTGCGCATGAAC
AACCTTTGCATCGACTAGTG -> ACCTTTGCATCGACTAGTGG
AACGAGTTGAAGCGCCCGAG -> ACGAGTTGAAGCGCCCGAGA
AACGCAGGCCTTTTGATTGA -> ACGCAGGCCTTTTGATTGAT
AACGCTCACGGGATTTAGAT -> ACGCTCACGGGATTTAGATT
AACGGAGGCTCTAGCGAACC -> ACGGAGGCTCTAGCGAACCT
AACTAGGTCGGACCGCCCTA -> ACTAGGTCGGACCGCCCTAA
AACTTGCTGAACATTATTAG -> ACTTGCTGAACATTATTAGG
AAGAAGATCGCCGCATTCAC -> AGAAGATCGCCGCATTCACT
AAGACGATGCTTCCAAAGGC -> AGACGATGCTTCCAAAGGCC
AAGATCGCCGCATTCACTCG -> AGATCGCCGCATTCACTCGG
AAGATTATCACCTCGCTTCG -> AGATTATCACCTCGCTTCGA
AAGCAGCCCCATGAGTACGC -> AGCAGCCCCATGAGTACGCA
AAGCAGGGGGTGTGTGCAGA -> AGCAGGGGGTGTGTGCAGAC
AAGCCCGGATAATTTGAATT -> AGCCCGGATAATTTGAATTA
AAGCGCCCGAGAGTGAGTTG -> AGCGCCCGAGAGTGAGTTGA
AAGCTGCGAGTCTTCCAGAG -> AGCTGCGAGTCTTCCAGAGG
AAGGCCAGGCTATGGCTGCA -> AGGCCAGGCTATGGCTGCAT
AAGGTAGCTTACTATCTCCG -> AGGTAGCTTACTATCTCCGT
AAGTCGGGCAGTAGAGGGGC -> AGTCGGGCAGTAGAGGGGCA
AAGTGCGTAGCGCCAACCAC -> AGTGCGTAGCGCCAACCACT
AAGTTCGCTGGTCACCCGCT -> AGTTCGCTGGTCACCCGCTG
AAGTTGAGAGGTTACGCTAG -> AGTTGAGAGGTTACGCTAGG
AATACGTGCGCACGTCAGCC -> ATACGTGCGCACGTCAGCCT
AATCATTAGGGAGGTTTCTC -> ATCATTAGGGAGGTTTCTCG
AATGAGTACCAATGGCTCTA -> ATGAGTACCAATGGCTCTAT
AATGGCTCTATTGAGAGCAT -> ATGGCTCTATTGAGAGCATG
AATGGCTGACATAAGCAGGG -> ATGGCTGACATAAGCAGGGG
AATGGGATGCAAGTCGGGCA -> ATGGGATGCAAGTCGGGCAG
AATGTCCACCAAATTATAGA -> ATGTCCACCAAATTATAGAT
AATTATAGATTGAGCGACAA -> ATTATAGATTGAGCGACAAC
AATTATGATGTAGAGATAGC -> ATTATGATGTAGAGATAGCC
AATTCTAGAGACTATCCAAT -> ATTCTAGAGACTATCCAATT
AATTCTCACTATAGTCGCCT -> ATTCTCACTATAGTCGCCTT
AATTCTTACGACCAACGAGT -> ATTCTTACGACCAACGAGTT
AATTTGAATTATGATGTAGA -> ATTTGAATTATGATGTAGAG
ACAAAACCCCTCTTGCTCAA -> CAAAACCCCTCTTGCTCAAT
ACAAAGCCCGGATAATTTGA -> CAAAGCCCGGATAATTTGAA
ACAAATGTCCACCAAATTAT -> CAAATGTCCACCAAATTATA
ACAACAAAGCCCGGATAATT -> CAACAAAGCCCGGATAATTT
ACACAAAACCCCTCTTGCTC -> CACAAAACCCCTCTTGCTCA
ACACCCTGGTGGAATCATTA -> CACCCTGGTGGAATCATTAG
ACACGTATGACCGGTCTCCA -> CACGTATGACCGGTCTCCAA
ACAGGCAGGATGCATGCCTC -> CAGGCAGGATGCATGCCTCT
ACATAAGCAGGGGGTGTGTG -> CATAAGCAGGGGGTGTGTGC
ACATTATTAGGCGAGATCAA -> CATTATTAGGCGAGATCAAT
ACCAAATTATAGATTGAGCG -> CCAAATTATAGATTGAGCGA
ACCAACGAGTTGAAGCGCCC -> CCAACGAGTTGAAGCGCCCG
ACCAATGGCTCTATTGAGAG -> CCAATGGCTCTATTGAGAGC
ACCACTGTTCAAGTTCGCTG -> CCACTGTTCAAGTTCGCTGG
ACCAGACACGTATGACCGGT -> CCAGACACGTATGACCGGTC
ACCCCTCTTGCTCAATGAGT -> CCCCTCTTGCTCAATGAGTA
ACCCGCTGGATTGCTACAAA -> CCCGCTGGATTGCTACAAAT
ACCCTGGTGGAATCATTAGG -> CCCTGGTGGAATCATTAGGG
ACCGAATGGGATGCAAGTCG -> CCGAATGGGATGCAAGTCGG
ACCGAGCAGTGACTTGGGAA -> CCGAGCAGTGACTTGGGAAG
ACCGCCCTAAAACACCCTGG -> CCGCCCTAAAACACCCTGGT
ACCGGTCTCCAACGCTCACG -> CCGGTCTCCAACGCTCACGG
ACCTAGCTATCCTGCATCTC -> CCTAGCTATCCTGCATCTCT
ACCTCGCTTCGACCGAGCAG -> CCTCGCTTCGACCGAGCAGT
ACCTGGCCCTGCGCATGAAC -> CCTGGCCCTGCGCATGAACC
ACCTTTGCATCGACTAGTGG -> CCTTTGCATCGACTAGTGGA
ACGAATTCTAGAGACTATCC -> CGAATTCTAGAGACTATCCA
ACGACCAACGAGTTGAAGCG -> CGACCAACGAGTTGAAGCGC
ACGACGAATTCTAGAGACTA -> CGACGAATTCTAGAGACTAT
ACGAGTACCTAGCTATCCTG -> CGAGTACCTAGCTATCCTGC
ACGAGTTGAAGCGCCCGAGA -> CGAGTTGAAGCGCCCGAGAG
ACGATGCTTCCAAAGGCCAG -> CGATGCTTCCAAAGGCCAGG
ACGCAAACGGAGGCTCTAGC -> CGCAAACGGAGGCTCTAGCG
ACGCACCGAATGGGATGCAA -> CGCACCGAATGGGATGCAAG
ACGCAGGCCTTTTGATTGAT -> CGCAGGCCTTTTGATTGATT
ACGCCGTAGGACGCACCGAA -> CGCCGTAGGACGCACCGAAT
ACGCTAGGCGGGGATTCGCC -> CGCTAGGCGGGGATTCGCCG
ACGCTCACGGGATTTAGATT -> CGCTCACGGGATTTAGATTG
ACGGAGGCTCTAGCGAACCT -> CGGAGGCTCTAGCGAACCTG
ACGGGATTTAGATTGCACGG -> CGGGATTTAGATTGCACGGG
ACGGGGGCAGCAAGGTAGCT -> CGGGGGCAGCAAGGTAGCTT
ACGGTGTAGAGAGATGATAA -> CGGTGTAGAGAGATGATAAA
ACGGTGTCGTAGAAGACGAT -> CGGTGTCGTAGAAGACGATG
ACGTACGAGTACCTAGCTAT -> CGTACGAGTACCTAGCTATC
ACGTATGACCGGTCTCCAAC -> CGTATGACCGGTCTCCAACG
ACGTCAGCCTATTCTTACCA -> CGTCAGCCTATTCTTACCAG
ACGTGCGCACGTCAGCCTAT -> CGTGCGCACGTCAGCCTATT
ACTAGGTCGGACCGCCCTAA -> CTAGGTCGGACCGCCCTAAA
ACTAGTGGATCCCATATTAG -> CTAGTGGATCCCATATTAGG
ACTATACACAAAACCCCTCT -> CTATACACAAAACCCCTCTT
ACTATAGTCGCCTTGGCCGA -> CTATAGTCGCCTTGGCCGAA
ACTATCCAATTCTCACTATA -> CTATCCAATTCTCACTATAG
ACTATCTCCGTGTGCGCCCA -> CTATCTCCGTGTGCGCCCAC
ACTCACTATACACAAAACCC -> CTCACTATACACAAAACCCC
ACTCGGTAAGCAGCCCCATG -> CTCGGTAAGCAGCCCCATGA
ACTGGTTGCAAACTTGCTGA -> CTGGTTGCAAACTTGCTGAA
ACTGTTCAAGTTCGCTGGTC -> CTGTTCAAGTTCGCTGGTCA
ACTTGAGGTCGGGGTACAGC -> CTTGAGGTCGGGGTACAGCT
ACTTGCTGAACATTATTAGG -> CTTGCTGAACATTATTAGGC
ACTTGGGAAGAAGATCGCCG -> CTTGGGAAGAAGATCGCCGC
AGAAGACGATGCTTCCAAAG -> GAAGACGATGCTTCCAAAGG
AGAAGATCGCCGCATTCACT -> GAAGATCGCCGCATTCACTC
AGACACGTATGACCGGTCTC -> GACACGTATGACCGGTCTCC
AGACGATGCTTCCAAAGGCC -> GACGATGCTTCCAAAGGCCA
AGACTATCCAATTCTCACTA -> GACTATCCAATTCTCACTAT
AGACTCACTATACACAAAAC -> GACTCACTATACACAAAACC
AGAGACTATCCAATTCTCAC -> GAGACTATCCAATTCTCACT
AGAGAGATGATAAATACGTG -> GAGAGATGATAAATACGTGC
AGAGATAGCCAACGCAGGCC -> GAGATAGCCAACGCAGGCCT
AGAGATGATAAATACGTGCG -> GAGATGATAAATACGTGCGC
AGAGCATGATCAAGCTGCGA -> GAGCATGATCAAGCTGCGAG
AGAGGGGCAGTAAACTAGGT -> GAGGGGCAGTAAACTAGGTC
AGAGGGTGGCCACAGGCAGG -> GAGGGTGGCCACAGGCAGGA
AGAGGTTACGCTAGGCGGGG -> GAGGTTACGCTAGGCGGGGA
AGAGTGAGTTGACGGTGTAG -> GAGTGAGTTGACGGTGTAGA
AGATAGCCAACGCAGGCCTT -> GATAGCCAACGCAGGCCTTT
AGATCAATTCTTACGACCAA -> GATCAATTCTTACGACCAAC
AGATCGCCGCATTCACTCGG -> GATCGCCGCATTCACTCGGT
AGATGATAAATACGTGCGCA -> GATGATAAATACGTGCGCAC
AGATTATCACCTCGCTTCGA -> GATTATCACCTCGCTTCGAC
AGATTGAGCGACAACAAAGC -> GATTGAGCGACAACAAAGCC
AGATTGCACGGGGGCAGCAA -> GATTGCACGGGGGCAGCAAG
AGCAAGGTAGCTTACTATCT -> GCAAGGTAGCTTACTATCTC
AGCAGCCCCATGAGTACGCA -> GCAGCCCCATGAGTACGCAA
AGCAGGGGGTGTGTGCAGAC -> GCAGGGGGTGTGTGCAGACT
AGCAGTGACTTGGGAAGAAG -> GCAGTGACTTGGGAAGAAGA
AGCAGTTGATTTCGCGATCC -> GCAGTTGATTTCGCGATCCC
AGCATGATCAAGCTGCGAGT -> GCATGATCAAGCTGCGAGTC
AGCCAACGCAGGCCTTTTGA -> GCCAACGCAGGCCTTTTGAT
AGCCCCATGAGTACGCAAAC -> GCCCCATGAGTACGCAAACG
AGCCCGGATAATTTGAATTA -> GCCCGGATAATTTGAATTAT
AGCCTATTCTTACCAGACAC -> GCCTATTCTTACCAGACACG
AGCGAACCTGGCCCTGCGCA -> GCGAACCTGGCCCTGCGCAT
AGCGACAACAAAGCCCGGAT -> GCGACAACAAAGCCCGGATA
AGCGCCAACCACTGTTCAAG -> GCGCCAACCACTGTTCAAGT
AGCGCCCGAGAGTGAGTTGA -> GCGCCCGAGAGTGAGTTGAC
AGCTATCCTGCATCTCTACG -> GCTATCCTGCATCTCTACGG
AGCTGCGAGTCTTCCAGAGG -> GCTGCGAGTCTTCCAGAGGG
AGCTTACTATCTCCGTGTGC -> GCTTACTATCTCCGTGTGCG
AGGACGCACCGAATGGGATG -> GGACGCACCGAATGGGATGC
AGGATGCATGCCTCTTAAGT -> GGATGCATGCCTCTTAAGTT
AGGCAGGATGCATGCCTCTT -> GGCAGGATGCATGCCTCTTA
AGGCCAGGCTATGGCTGCAT -> GGCCAGGCTATGGCTGCATA
AGGCCTTTTGATTGATTAGC -> GGCCTTTTGATTGATTAGCA
AGGCGAGATCAATTCTTACG -> GGCGAGATCAATTCTTACGA
AGGCGGGGATTCGCCGCACG -> GGCGGGGATTCGCCGCACGT
AGGCTATGGCTGCATACGAC -> GGCTATGGCTGCATACGACG
AGGCTCTAGCGAACCTGGCC -> GGCTCTAGCGAACCTGGCCC
AGGGAGGTTTCTCGACTGGT -> GGGAGGTTTCTCGACTGGTT
AGGGCGTGCTTGCTGGCCAT -> GGGCGTGCTTGCTGGCCATG
AGGGGCAGTAAACTAGGTCG -> GGGGCAGTAAACTAGGTCGG
AGGGGGTGTGTGCAGACTCA -> GGGGGTGTGTGCAGACTCAC
AGGGTGGCCACAGGCAGGAT -> GGGTGGCCACAGGCAGGATG
AGGTAGCTTACTATCTCCGT -> GGTAGCTTACTATCTCCGTG
AGGTCGGACCGCCCTAAAAC -> GGTCGGACCGCCCTAAAACA
AGGTTACGCTAGGCGGGGAT -> GGTTACGCTAGGCGGGGATT
AGGTTTCTCGACTGGTTGCA -> GGTTTCTCGACTGGTTGCAA
AGTAAACTAGGTCGGACCGC -> GTAAACTAGGTCGGACCGCC
AGTACCAATGGCTCTATTGA -> GTACCAATGGCTCTATTGAG
AGTACCTAGCTATCCTGCAT -> GTACCTAGCTATCCTGCATC
AGTACGCAAACGGAGGCTCT -> GTACGCAAACGGAGGCTCTA
AGTAGAGGGGCAGTAAACTA -> GTAGAGGGGCAGTAAACTAG
AGTCGCCTTGGCCGAAGTGC -> GTCGCCTTGGCCGAAGTGCG
AGTCGGGCAGTAGAGGGGCA -> GTCGGGCAGTAGAGGGGCAG
AGTCTTCCAGAGGGTGGCCA -> GTCTTCCAGAGGGTGGCCAC
AGTGACTTGGGAAGAAGATC -> GTGACTTGGGAAGAAGATCG
AGTGAGTTGACGGTGTAGAG -> GTGAGTTGACGGTGTAGAGA
AGTGCGTAGCGCCAACCACT -> GTGCGTAGCGCCAACCACTG
AGTGGATCCCATATTAGGGC -> GTGGATCCCATATTAGGGCG
AGTTCGCTGGTCACCCGCTG -> GTTCGCTGGTCACCCGCTGG
AGTTGAAGCGCCCGAGAGTG -> GTTGAAGCGCCCGAGAGTGA
AGTTGACGGTGTAGAGAGAT -> GTTGACGGTGTAGAGAGATG
AGTTGAGAGGTTACGCTAGG -> GTTGAGAGGTTACGCTAGGC
AGTTGATTTCGCGATCCCCT -> GTTGATTTCGCGATCCCCTC
ATAAATACGTGCGCACGTCA -> TAAATACGTGCGCACGTCAG
ATAAGCAGGGGGTGTGTGCA -> TAAGCAGGGGGTGTGTGCAG
ATAATTTGAATTATGATGTA -> TAATTTGAATTATGATGTAG
ATACACAAAACCCCTCTTGC -> TACACAAAACCCCTCTTGCT
ATACGACGAATTCTAGAGAC -> TACGACGAATTCTAGAGACT
ATACGTGCGCACGTCAGCCT -> TACGTGCGCACGTCAGCCTA
ATAGATTGAGCGACAACAAA -> TAGATTGAGCGACAACAAAG
ATAGCCAACGCAGGCCTTTT -> TAGCCAACGCAGGCCTTTTG
ATAGTCGCCTTGGCCGAAGT -> TAGTCGCCTTGGCCGAAGTG
ATATTAGGGCGTGCTTGCTG -> TATTAGGGCGTGCTTGCTGG
ATCAAGCTGCGAGTCTTCCA -> TCAAGCTGCGAGTCTTCCAG
ATCAATTCTTACGACCAACG -> TCAATTCTTACGACCAACGA
ATCACCTCGCTTCGACCGAG -> TCACCTCGCTTCGACCGAGC
ATCATTAGGGAGGTTTCTCG -> TCATTAGGGAGGTTTCTCGA
ATCCAATTCTCACTATAGTC -> TCCAATTCTCACTATAGTCG
ATCCCATATTAGGGCGTGCT -> TCCCATATTAGGGCGTGCTT
ATCCCCTCGTTCCACGCCGT -> TCCCCTCGTTCCACGCCGTA
ATCCTGCATCTCTACGGTGT -> TCCTGCATCTCTACGGTGTC
ATCGACTAGTGGATCCCATA -> TCGACTAGTGGATCCCATAT
ATCGCCGCATTCACTCGGTA -> TCGCCGCATTCACTCGGTAA
ATCTCCGTGTGCGCCCACTT -> TCTCCGTGTGCGCCCACTTG
ATCTCTACGGTGTCGTAGAA -> TCTCTACGGTGTCGTAGAAG
ATGAACCTTTGCATCGACTA -> TGAACCTTTGCATCGACTAG
ATGACCGGTCTCCAACGCTC -> TGACCGGTCTCCAACGCTCA
ATGAGTACCAATGGCTCTAT -> TGAGTACCAATGGCTCTATT
ATGAGTACGCAAACGGAGGC -> TGAGTACGCAAACGGAGGCT
ATGATAAATACGTGCGCACG -> TGATAAATACGTGCGCACGT
ATGATCAAGCTGCGAGTCTT -> TGATCAAGCTGCGAGTCTTC
ATGATGTAGAGATAGCCAAC -> TGATGTAGAGATAGCCAACG
ATGCAAGTCGGGCAGTAGAG -> TGCAAGTCGGGCAGTAGAGG
ATGCATGCCTCTTAAGTTGA -> TGCATGCCTCTTAAGTTGAG
ATGCCTCTTAAGTTGAGAGG -> TGCCTCTTAAGTTGAGAGGT
ATGCTTCCAAAGGCCAGGCT -> TGCTTCCAAAGGCCAGGCTA
ATGCTTCCGAATGGCTGACA -> TGCTTCCGAATGGCTGACAT
ATGGCTCTATTGAGAGCATG -> TGGCTCTATTGAGAGCATGA
ATGGCTGACATAAGCAGGGG -> TGGCTGACATAAGCAGGGGG
ATGGCTGCATACGACGAATT -> TGGCTGCATACGACGAATTC
ATGGGATGCAAGTCGGGCAG -> TGGGATGCAAGTCGGGCAGT
ATGTAGAGATAGCCAACGCA -> TGTAGAGATAGCCAACGCAG
ATGTCCACCAAATTATAGAT -> TGTCCACCAAATTATAGATT
ATTAGCAGTTGATTTCGCGA -> TTAGCAGTTGATTTCGCGAT
ATTAGGCGAGATCAATTCTT -> TTAGGCGAGATCAATTCTTA
ATTAGGGAGGTTTCTCGACT -> TTAGGGAGGTTTCTCGACTG
ATTAGGGCGTGCTTGCTGGC -> TTAGGGCGTGCTTGCTGGCC
ATTATAGATTGAGCGACAAC -> TTATAGATTGAGCGACAACA
ATTATCACCTCGCTTCGACC -> TTATCACCTCGCTTCGACCG
ATTATGATGTAGAGATAGCC -> TTATGATGTAGAGATAGCCA
ATTATTAGGCGAGATCAATT -> TTATTAGGCGAGATCAATTC
ATTCACTCGGTAAGCAGCCC -> TTCACTCGGTAAGCAGCCCC
ATTCGCCGCACGTACGAGTA -> TTCGCCGCACGTACGAGTAC
ATTCTAGAGACTATCCAATT -> TTCTAGAGACTATCCAATTC
ATTCTCACTATAGTCGCCTT -> TTCTCACTATAGTCGCCTTG
ATTCTTACCAGACACGTATG -> TTCTTACCAGACACGTATGA
ATTCTTACGACCAACGAGTT -> TTCTTACGACCAACGAGTTG
ATTGAGAGCATGATCAAGCT -> TTGAGAGCATGATCAAGCTG
ATTGAGCGACAACAAAGCCC -> TTGAGCGACAACAAAGCCCG
ATTGATTAGCAGTTGATTTC -> TTGATTAGCAGTTGATTTCG
ATTGCACGGGGGCAGCAAGG -> TTGCACGGGGGCAGCAAGGT
ATTGCTACAAATGTCCACCA -> TTGCTACAAATGTCCACCAA
ATTTAGATTGCACGGGGGCA -> TTTAGATTGCACGGGGGCAG
ATTTCGCGATCCCCTCGTTC -> TTTCGCGATCCCCTCGTTCC
ATTTGAATTATGATGTAGAG -> TTTGAATTATGATGTAGAGA
CAAAACCCCTCTTGCTCAAT -> AAAACCCCTCTTGCTCAATG
CAAACGGAGGCTCTAGCGAA -> AAACGGAGGCTCTAGCGAAC
CAAACTTGCTGAACATTATT -> AAACTTGCTGAACATTATTA
CAAAGCCCGGATAATTTGAA -> AAAGCCCGGATAATTTGAAT
CAAAGGCCAGGCTATGGCTG -> AAAGGCCAGGCTATGGCTGC
CAAATGTCCACCAAATTATA -> AAATGTCCACCAAATTATAG
CAAATTATAGATTGAGCGAC -> AAATTATAGATTGAGCGACA
CAACAAAGCCCGGATAATTT -> AACAAAGCCCGGATAATTTG
CAACCACTGTTCAAGTTCGC -> AACCACTGTTCAAGTTCGCT
CAACGAGTTGAAGCGCCCGA -> AACGAGTTGAAGCGCCCGAG
CAACGCAGGCCTTTTGATTG -> AACGCAGGCCTTTTGATTGA
CAACGCTCACGGGATTTAGA -> AACGCTCACGGGATTTAGAT
CAAGCTGCGAGTCTTCCAGA -> AAGCTGCGAGTCTTCCAGAG
CAAGGTAGCTTACTATCTCC -> AAGGTAGCTTACTATCTCCG
CAAGTCGGGCAGTAGAGGGG -> AAGTCGGGCAGTAGAGGGGC
CAAGTTCGCTGGTCACCCGC -> AAGTTCGCTGGTCACCCGCT
CAATGAGTACCAATGGCTCT -> AATGAGTACCAATGGCTCTA
CAATGGCTCTATTGAGAGCA -> AATGGCTCTATTGAGAGCAT
CAATTCTCACTATAGTCGCC -> AATTCTCACTATAGTCGCCT
CAATTCTTACGACCAACGAG -> AATTCTTACGACCAACGAGT
CACAAAACCCCTCTTGCTCA -> ACAAAACCCCTCTTGCTCAA
CACAGGCAGGATGCATGCCT -> ACAGGCAGGATGCATGCCTC
CACCAAATTATAGATTGAGC -> ACCAAATTATAGATTGAGCG
CACCCGCTGGATTGCTACAA -> ACCCGCTGGATTGCTACAAA
CACCCTGGTGGAATCATTAG -> ACCCTGGTGGAATCATTAGG
CACCGAATGGGATGCAAGTC -> ACCGAATGGGATGCAAGTCG
CACCTCGCTTCGACCGAGCA -> ACCTCGCTTCGACCGAGCAG
CACGCCGTAGGACGCACCGA -> ACGCCGTAGGACGCACCGAA
CACGGGATTTAGATTGCACG -> ACGGGATTTAGATTGCACGG
CACGGGGGCAGCAAGGTAGC -> ACGGGGGCAGCAAGGTAGCT
CACGTACGAGTACCTAGCTA -> ACGTACGAGTACCTAGCTAT
CACGTATGACCGGTCTCCAA -> ACGTATGACCGGTCTCCAAC
CACGTCAGCCTATTCTTACC -> ACGTCAGCCTATTCTTACCA
CACTATACACAAAACCCCTC -> ACTATACACAAAACCCCTCT
CACTATAGTCGCCTTGGCCG -> ACTATAGTCGCCTTGGCCGA
CACTCGGTAAGCAGCCCCAT -> ACTCGGTAAGCAGCCCCATG
CACTGTTCAAGTTCGCTGGT -> ACTGTTCAAGTTCGCTGGTC
CACTTGAGGTCGGGGTACAG -> ACTTGAGGTCGGGGTACAGC
CAGACACGTATGACCGGTCT -> AGACACGTATGACCGGTCTC
CAGACTCACTATACACAAAA -> AGACTCACTATACACAAAAC
CAGAGGGTGGCCACAGGCAG -> AGAGGGTGGCCACAGGCAGG
CAGCAAGGTAGCTTACTATC -> AGCAAGGTAGCTTACTATCT
CAGCCCCATGAGTACGCAAA -> AGCCCCATGAGTACGCAAAC
CAGCCTATTCTTACCAGACA -> AGCCTATTCTTACCAGACAC
CAGGATGCATGCCTCTTAAG -> AGGATGCATGCCTCTTAAGT
CAGGCAGGATGCATGCCTCT -> AGGCAGGATGCATGCCTCTT
CAGGCCTTTTGATTGATTAG -> AGGCCTTTTGATTGATTAGC
CAGGCTATGGCTGCATACGA -> AGGCTATGGCTGCATACGAC
CAGGGGGTGTGTGCAGACTC -> AGGGGGTGTGTGCAGACTCA
CAGTAAACTAGGTCGGACCG -> AGTAAACTAGGTCGGACCGC
CAGTAGAGGGGCAGTAAACT -> AGTAGAGGGGCAGTAAACTA
CAGTGACTTGGGAAGAAGAT -> AGTGACTTGGGAAGAAGATC
CAGTTGATTTCGCGATCCCC -> AGTTGATTTCGCGATCCCCT
CATAAGCAGGGGGTGTGTGC -> ATAAGCAGGGGGTGTGTGCA
CATACGACGAATTCTAGAGA -> ATACGACGAATTCTAGAGAC
CATATTAGGGCGTGCTTGCT -> ATATTAGGGCGTGCTTGCTG
CATCGACTAGTGGATCCCAT -> ATCGACTAGTGGATCCCATA
CATCTCTACGGTGTCGTAGA -> ATCTCTACGGTGTCGTAGAA
CATGAACCTTTGCATCGACT -> ATGAACCTTTGCATCGACTA
CATGAGTACGCAAACGGAGG -> ATGAGTACGCAAACGGAGGC
CATGATCAAGCTGCGAGTCT -> ATGATCAAGCTGCGAGTCTT
CATGCCTCTTAAGTTGAGAG -> ATGCCTCTTAAGTTGAGAGG
CATGCTTCCGAATGGCTGAC -> ATGCTTCCGAATGGCTGACA
CATTAGGGAGGTTTCTCGAC -> ATTAGGGAGGTTTCTCGACT
CATTATTAGGCGAGATCAAT -> ATTATTAGGCGAGATCAATT
CATTCACTCGGTAAGCAGCC -> ATTCACTCGGTAAGCAGCCC
CCAAAGGCCAGGCTATGGCT -> CAAAGGCCAGGCTATGGCTG
CCAAATTATAGATTGAGCGA -> CAAATTATAGATTGAGCGAC
CCAACCACTGTTCAAGTTCG -> CAACCACTGTTCAAGTTCGC
CCAACGAGTTGAAGCGCCCG -> CAACGAGTTGAAGCGCCCGA
CCAACGCAGGCCTTTTGATT -> CAACGCAGGCCTTTTGATTG
CCAACGCTCACGGGATTTAG -> CAACGCTCACGGGATTTAGA
CCAATGGCTCTATTGAGAGC -> CAATGGCTCTATTGAGAGCA
CCAATTCTCACTATAGTCGC -> CAATTCTCACTATAGTCGCC
CCACAGGCAGGATGCATGCC -> CACAGGCAGGATGCATGCCT
CCACCAAATTATAGATTGAG -> CACCAAATTATAGATTGAGC
CCACGCCGTAGGACGCACCG -> CACGCCGTAGGACGCACCGA
CCACTGTTCAAGTTCGCTGG -> CACTGTTCAAGTTCGCTGGT
CCACTTGAGGTCGGGGTACA -> CACTTGAGGTCGGGGTACAG
CCAGACACGTATGACCGGTC -> CAGACACGTATGACCGGTCT
CCAGAGGGTGGCCACAGGCA -> CAGAGGGTGGCCACAGGCAG
CCAGGCTATGGCTGCATACG -> CAGGCTATGGCTGCATACGA
CCATATTAGGGCGTGCTTGC -> CATATTAGGGCGTGCTTGCT
CCATGAGTACGCAAACGGAG -> CATGAGTACGCAAACGGAGG
CCATGCTTCCGAATGGCTGA -> CATGCTTCCGAATGGCTGAC
CCCACTTGAGGTCGGGGTAC -> CCACTTGAGGTCGGGGTACA
CCCATATTAGGGCGTGCTTG -> CCATATTAGGGCGTGCTTGC
CCCATGAGTACGCAAACGGA -> CCATGAGTACGCAAACGGAG
CCCCATGAGTACGCAAACGG -> CCCATGAGTACGCAAACGGA
CCCCTCGTTCCACGCCGTAG -> CCCTCGTTCCACGCCGTAGG
CCCCTCTTGCTCAATGAGTA -> CCCTCTTGCTCAATGAGTAC
CCCGAGAGTGAGTTGACGGT -> CCGAGAGTGAGTTGACGGTG
CCCGCTGGATTGCTACAAAT -> CCGCTGGATTGCTACAAATG
CCCGGATAATTTGAATTATG -> CCGGATAATTTGAATTATGA
CCCTAAAACACCCTGGTGGA -> CCTAAAACACCCTGGTGGAA
CCCTCGTTCCACGCCGTAGG -> CCTCGTTCCACGCCGTAGGA
CCCTCTTGCTCAATGAGTAC -> CCTCTTGCTCAATGAGTACC
CCCTGCGCATGAACCTTTGC -> CCTGCGCATGAACCTTTGCA
CCCTGGTGGAATCATTAGGG -> CCTGGTGGAATCATTAGGGA
CCGAAGTGCGTAGCGCCAAC -> CGAAGTGCGTAGCGCCAACC
CCGAATGGCTGACATAAGCA -> CGAATGGCTGACATAAGCAG
CCGAATGGGATGCAAGTCGG -> CGAATGGGATGCAAGTCGGG
CCGAGAGTGAGTTGACGGTG -> CGAGAGTGAGTTGACGGTGT
CCGAGCAGTGACTTGGGAAG -> CGAGCAGTGACTTGGGAAGA
CCGCACGTACGAGTACCTAG -> CGCACGTACGAGTACCTAGC
CCGCATTCACTCGGTAAGCA -> CGCATTCACTCGGTAAGCAG
CCGCCCTAAAACACCCTGGT -> CGCCCTAAAACACCCTGGTG
CCGCTGGATTGCTACAAATG -> CGCTGGATTGCTACAAATGT
CCGGATAATTTGAATTATGA -> CGGATAATTTGAATTATGAT
CCGGTCTCCAACGCTCACGG -> CGGTCTCCAACGCTCACGGG
CCGTAGGACGCACCGAATGG -> CGTAGGACGCACCGAATGGG
CCGTGTGCGCCCACTTGAGG -> CGTGTGCGCCCACTTGAGGT
CCTAAAACACCCTGGTGGAA -> CTAAAACACCCTGGTGGAAT
CCTAGCTATCCTGCATCTCT -> CTAGCTATCCTGCATCTCTA
CCTATTCTTACCAGACACGT -> CTATTCTTACCAGACACGTA
CCTCGCTTCGACCGAGCAGT -> CTCGCTTCGACCGAGCAGTG
CCTCGTTCCACGCCGTAGGA -> CTCGTTCCACGCCGTAGGAC
CCTCTTAAGTTGAGAGGTTA -> CTCTTAAGTTGAGAGGTTAC
CCTCTTGCTCAATGAGTACC -> CTCTTGCTCAATGAGTACCA
CCTGCATCTCTACGGTGTCG -> CTGCATCTCTACGGTGTCGT
CCTGCGCATGAACCTTTGCA -> CTGCGCATGAACCTTTGCAT
CCTGGCCCTGCGCATGAACC -> CTGGCCCTGCGCATGAACCT
CCTGGTGGAATCATTAGGGA -> CTGGTGGAATCATTAGGGAG
CCTTGGCCGAAGTGCGTAGC -> CTTGGCCGAAGTGCGTAGCG
CCTTTGCATCGACTAGTGGA -> CTTTGCATCGACTAGTGGAT
CCTTTTGATTGATTAGCAGT -> CTTTTGATTGATTAGCAGTT
CGAACCTGGCCCTGCGCATG -> GAACCTGGCCCTGCGCATGA
CGAAGTGCGTAGCGCCAACC -> GAAGTGCGTAGCGCCAACCA
CGAATGGCTGACATAAGCAG -> GAATGGCTGACATAAGCAGG
CGAATGGGATGCAAGTCGGG -> GAATGGGATGCAAGTCGGGC
CGAATTCTAGAGACTATCCA -> GAATTCTAGAGACTATCCAA
CGACAACAAAGCCCGGATAA -> GACAACAAAGCCCGGATAAT
CGACCAACGAGTTGAAGCGC -> GACCAACGAGTTGAAGCGCC
CGACCGAGCAGTGACTTGGG -> GACCGAGCAGTGACTTGGGA
CGACGAATTCTAGAGACTAT -> GACGAATTCTAGAGACTATC
CGACTAGTGGATCCCATATT -> GACTAGTGGATCCCATATTA
CGACTGGTTGCAAACTTGCT -> GACTGGTTGCAAACTTGCTG
CGAGAGTGAGTTGACGGTGT -> GAGAGTGAGTTGACGGTGTA
CGAGATCAATTCTTACGACC -> GAGATCAATTCTTACGACCA
CGAGCAGTGACTTGGGAAGA -> GAGCAGTGACTTGGGAAGAA
CGAGTACCTAGCTATCCTGC -> GAGTACCTAGCTATCCTGCA
CGAGTCTTCCAGAGGGTGGC -> GAGTCTTCCAGAGGGTGGCC
CGAGTTGAAGCGCCCGAGAG -> GAGTTGAAGCGCCCGAGAGT
CGATCCCCTCGTTCCACGCC -> GATCCCCTCGTTCCACGCCG
CGATGCTTCCAAAGGCCAGG -> GATGCTTCCAAAGGCCAGGC
CGCAAACGGAGGCTCTAGCG -> GCAAACGGAGGCTCTAGCGA
CGCACCGAATGGGATGCAAG -> GCACCGAATGGGATGCAAGT
CGCACGTACGAGTACCTAGC -> GCACGTACGAGTACCTAGCT
CGCACGTCAGCCTATTCTTA -> GCACGTCAGCCTATTCTTAC
CGCAGGCCTTTTGATTGATT -> GCAGGCCTTTTGATTGATTA
CGCATGAACCTTTGCATCGA -> GCATGAACCTTTGCATCGAC
CGCATTCACTCGGTAAGCAG -> GCATTCACTCGGTAAGCAGC
CGCCAACCACTGTTCAAGTT -> GCCAACCACTGTTCAAGTTC
CGCCCACTTGAGGTCGGGGT -> GCCCACTTGAGGTCGGGGTA
CGCCCGAGAGTGAGTTGACG -> GCCCGAGAGTGAGTTGACGG
CGCCCTAAAACACCCTGGTG -> GCCCTAAAACACCCTGGTGG
CGCCGCACGTACGAGTACCT -> GCCGCACGTACGAGTACCTA
CGCCGCATTCACTCGGTAAG -> GCCGCATTCACTCGGTAAGC
CGCCGTAGGACGCACCGAAT -> GCCGTAGGACGCACCGAATG
CGCCTTGGCCGAAGTGCGTA -> GCCTTGGCCGAAGTGCGTAG
CGCGATCCCCTCGTTCCACG -> GCGATCCCCTCGTTCCACGC
CGCTAGGCGGGGATTCGCCG -> GCTAGGCGGGGATTCGCCGC
CGCTCACGGGATTTAGATTG -> GCTCACGGGATTTAGATTGC
CGCTGGATTGCTACAAATGT -> GCTGGATTGCTACAAATGTC
CGCTGGTCACCCGCTGGATT -> GCTGGTCACCCGCTGGATTG
CGCTTCGACCGAGCAGTGAC -> GCTTCGACCGAGCAGTGACT
CGGACCGCCCTAAAACACCC -> GGACCGCCCTAAAACACCCT
CGGAGGCTCTAGCGAACCTG -> GGAGGCTCTAGCGAACCTGG
CGGATAATTTGAATTATGAT -> GGATAATTTGAATTATGATG
CGGGATTTAGATTGCACGGG -> GGGATTTAGATTGCACGGGG
CGGGCAGTAGAGGGGCAGTA -> GGGCAGTAGAGGGGCAGTAA
CGGGGATTCGCCGCACGTAC -> GGGGATTCGCCGCACGTACG
CGGGGGCAGCAAGGTAGCTT -> GGGGGCAGCAAGGTAGCTTA
CGGTAAGCAGCCCCATGAGT -> GGTAAGCAGCCCCATGAGTA
CGGTCTCCAACGCTCACGGG -> GGTCTCCAACGCTCACGGGA
CGGTGTAGAGAGATGATAAA -> GGTGTAGAGAGATGATAAAT
CGGTGTCGTAGAAGACGATG -> GGTGTCGTAGAAGACGATGC
CGTACGAGTACCTAGCTATC -> GTACGAGTACCTAGCTATCC
CGTAGAAGACGATGCTTCCA -> GTAGAAGACGATGCTTCCAA
CGTAGCGCCAACCACTGTTC -> GTAGCGCCAACCACTGTTCA
CGTAGGACGCACCGAATGGG -> GTAGGACGCACCGAATGGGA
CGTATGACCGGTCTCCAACG -> GTATGACCGGTCTCCAACGC
CGTCAGCCTATTCTTACCAG -> GTCAGCCTATTCTTACCAGA
CGTGCGCACGTCAGCCTATT -> GTGCGCACGTCAGCCTATTC
CGTGCTTGCTGGCCATGCTT -> GTGCTTGCTGGCCATGCTTC
CGTGTGCGCCCACTTGAGGT -> GTGTGCGCCCACTTGAGGTC
CGTTCCACGCCGTAGGACGC -> GTTCCACGCCGTAGGACGCA
CTAAAACACCCTGGTGGAAT -> TAAAACACCCTGGTGGAATC
CTACAAATGTCCACCAAATT -> TACAAATGTCCACCAAATTA
CTACGGTGTCGTAGAAGACG -> TACGGTGTCGTAGAAGACGA
CTAGAGACTATCCAATTCTC -> TAGAGACTATCCAATTCTCA
CTAGCGAACCTGGCCCTGCG -> TAGCGAACCTGGCCCTGCGC
CTAGCTATCCTGCATCTCTA -> TAGCTATCCTGCATCTCTAC
CTAGGCGGGGATTCGCCGCA -> TAGGCGGGGATTCGCCGCAC
CTAGGTCGGACCGCCCTAAA -> TAGGTCGGACCGCCCTAAAA
CTAGTGGATCCCATATTAGG -> TAGTGGATCCCATATTAGGG
CTATACACAAAACCCCTCTT -> TATACACAAAACCCCTCTTG
CTATAGTCGCCTTGGCCGAA -> TATAGTCGCCTTGGCCGAAG
CTATCCAATTCTCACTATAG -> TATCCAATTCTCACTATAGT
CTATCCTGCATCTCTACGGT -> TATCCTGCATCTCTACGGTG
CTATCTCCGTGTGCGCCCAC -> TATCTCCGTGTGCGCCCACT
CTATGGCTGCATACGACGAA -> TATGGCTGCATACGACGAAT
CTATTCTTACCAGACACGTA -> TATTCTTACCAGACACGTAT
CTATTGAGAGCATGATCAAG -> TATTGAGAGCATGATCAAGC
CTCAATGAGTACCAATGGCT -> TCAATGAGTACCAATGGCTC
CTCACGGGATTTAGATTGCA -> TCACGGGATTTAGATTGCAC
CTCACTATACACAAAACCCC -> TCACTATACACAAAACCCCT
CTCACTATAGTCGCCTTGGC -> TCACTATAGTCGCCTTGGCC
CTCCAACGCTCACGGGATTT -> TCCAACGCTCACGGGATTTA
CTCCGTGTGCGCCCACTTGA -> TCCGTGTGCGCCCACTTGAG
CTCGACTGGTTGCAAACTTG -> TCGACTGGTTGCAAACTTGC
CTCGCTTCGACCGAGCAGTG -> TCGCTTCGACCGAGCAGTGA
CTCGGTAAGCAGCCCCATGA -> TCGGTAAGCAGCCCCATGAG
CTCGTTCCACGCCGTAGGAC -> TCGTTCCACGCCGTAGGACG
CTCTACGGTGTCGTAGAAGA -> TCTACGGTGTCGTAGAAGAC
CTCTAGCGAACCTGGCCCTG -> TCTAGCGAACCTGGCCCTGC
CTCTATTGAGAGCATGATCA -> TCTATTGAGAGCATGATCAA
CTCTTAAGTTGAGAGGTTAC -> TCTTAAGTTGAGAGGTTACG
CTCTTGCTCAATGAGTACCA -> TCTTGCTCAATGAGTACCAA
CTGAACATTATTAGGCGAGA -> TGAACATTATTAGGCGAGAT
CTGACATAAGCAGGGGGTGT -> TGACATAAGCAGGGGGTGTG
CTGCATACGACGAATTCTAG -> TGCATACGACGAATTCTAGA
CTGCATCTCTACGGTGTCGT -> TGCATCTCTACGGTGTCGTA
CTGCGAGTCTTCCAGAGGGT -> TGCGAGTCTTCCAGAGGGTG
CTGCGCATGAACCTTTGCAT -> TGCGCATGAACCTTTGCATC
CTGGATTGCTACAAATGTCC -> TGGATTGCTACAAATGTCCA
CTGGCCATGCTTCCGAATGG -> TGGCCATGCTTCCGAATGGC
CTGGCCCTGCGCATGAACCT -> TGGCCCTGCGCATGAACCTT
CTGGTCACCCGCTGGATTGC -> TGGTCACCCGCTGGATTGCT
CTGGTGGAATCATTAGGGAG -> TGGTGGAATCATTAGGGAGG
CTGGTTGCAAACTTGCTGAA -> TGGTTGCAAACTTGCTGAAC
CTGTTCAAGTTCGCTGGTCA -> TGTTCAAGTTCGCTGGTCAC
CTTAAGTTGAGAGGTTACGC -> TTAAGTTGAGAGGTTACGCT
CTTACCAGACACGTATGACC -> TTACCAGACACGTATGACCG
CTTACGACCAACGAGTTGAA -> TTACGACCAACGAGTTGAAG
CTTACTATCTCCGTGTGCGC -> TTACTATCTCCGTGTGCGCC
CTTCCAAAGGCCAGGCTATG -> TTCCAAAGGCCAGGCTATGG
CTTCCAGAGGGTGGCCACAG -> TTCCAGAGGGTGGCCACAGG
CTTCCGAATGGCTGACATAA -> TTCCGAATGGCTGACATAAG
CTTCGACCGAGCAGTGACTT -> TTCGACCGAGCAGTGACTTG
CTTGCTCAATGAGTACCAAT -> TTGCTCAATGAGTACCAATG
CTTGCTGAACATTATTAGGC -> TTGCTGAACATTATTAGGCG
CTTGCTGGCCATGCTTCCGA -> TTGCTGGCCATGCTTCCGAA
CTTGGCCGAAGTGCGTAGCG -> TTGGCCGAAGTGCGTAGCGC
CTTGGGAAGAAGATCGCCGC -> TTGGGAAGAAGATCGCCGCA
CTTTGCATCGACTAGTGGAT -> TTTGCATCGACTAGTGGATC
CTTTTGATTGATTAGCAGTT -> TTTTGATTGATTAGCAGTTG
GAACATTATTAGGCGAGATC -> AACATTATTAGGCGAGATCA
GAACCTGGCCCTGCGCATGA -> AACCTGGCCCTGCGCATGAA
GAACCTTTGCATCGACTAGT -> AACCTTTGCATCGACTAGTG
GAAGAAGATCGCCGCATTCA -> AAGAAGATCGCCGCATTCAC
GAAGACGATGCTTCCAAAGG -> AAGACGATGCTTCCAAAGGC
GAAGATCGCCGCATTCACTC -> AAGATCGCCGCATTCACTCG
GAAGCGCCCGAGAGTGAGTT -> AAGCGCCCGAGAGTGAGTTG
GAAGTGCGTAGCGCCAACCA -> AAGTGCGTAGCGCCAACCAC
GAATCATTAGGGAGGTTTCT -> AATCATTAGGGAGGTTTCTC
GAATGGCTGACATAAGCAGG -> AATGGCTGACATAAGCAGGG
GAATGGGATGCAAGTCGGGC -> AATGGGATGCAAGTCGGGCA
GAATTATGATGTAGAGATAG -> AATTATGATGTAGAGATAGC
GAATTCTAGAGACTATCCAA -> AATTCTAGAGACTATCCAAT
GACAACAAAGCCCGGATAAT -> ACAACAAAGCCCGGATAATT
GACACGTATGACCGGTCTCC -> ACACGTATGACCGGTCTCCA
GACATAAGCAGGGGGTGTGT -> ACATAAGCAGGGGGTGTGTG
GACCAACGAGTTGAAGCGCC -> ACCAACGAGTTGAAGCGCCC
GACCGAGCAGTGACTTGGGA -> ACCGAGCAGTGACTTGGGAA
GACCGCCCTAAAACACCCTG -> ACCGCCCTAAAACACCCTGG
GACCGGTCTCCAACGCTCAC -> ACCGGTCTCCAACGCTCACG
GACGAATTCTAGAGACTATC -> ACGAATTCTAGAGACTATCC
GACGATGCTTCCAAAGGCCA -> ACGATGCTTCCAAAGGCCAG
GACGCACCGAATGGGATGCA -> ACGCACCGAATGGGATGCAA
GACGGTGTAGAGAGATGATA -> ACGGTGTAGAGAGATGATAA
GACTAGTGGATCCCATATTA -> ACTAGTGGATCCCATATTAG
GACTATCCAATTCTCACTAT -> ACTATCCAATTCTCACTATA
GACTCACTATACACAAAACC -> ACTCACTATACACAAAACCC
GACTGGTTGCAAACTTGCTG -> ACTGGTTGCAAACTTGCTGA
GACTTGGGAAGAAGATCGCC -> ACTTGGGAAGAAGATCGCCG
GAGACTATCCAATTCTCACT -> AGACTATCCAATTCTCACTA
GAGAGATGATAAATACGTGC -> AGAGATGATAAATACGTGCG
GAGAGCATGATCAAGCTGCG -> AGAGCATGATCAAGCTGCGA
GAGAGGTTACGCTAGGCGGG -> AGAGGTTACGCTAGGCGGGG
GAGAGTGAGTTGACGGTGTA -> AGAGTGAGTTGACGGTGTAG
GAGATAGCCAACGCAGGCCT -> AGATAGCCAACGCAGGCCTT
GAGATCAATTCTTACGACCA -> AGATCAATTCTTACGACCAA
GAGATGATAAATACGTGCGC -> AGATGATAAATACGTGCGCA
GAGCAGTGACTTGGGAAGAA -> AGCAGTGACTTGGGAAGAAG
GAGCATGATCAAGCTGCGAG -> AGCATGATCAAGCTGCGAGT
GAGCGACAACAAAGCCCGGA -> AGCGACAACAAAGCCCGGAT
GAGGCTCTAGCGAACCTGGC -> AGGCTCTAGCGAACCTGGCC
GAGGGGCAGTAAACTAGGTC -> AGGGGCAGTAAACTAGGTCG
GAGGGTGGCCACAGGCAGGA -> AGGGTGGCCACAGGCAGGAT
GAGGTTACGCTAGGCGGGGA -> AGGTTACGCTAGGCGGGGAT
GAGGTTTCTCGACTGGTTGC -> AGGTTTCTCGACTGGTTGCA
GAGTACCAATGGCTCTATTG -> AGTACCAATGGCTCTATTGA
GAGTACCTAGCTATCCTGCA -> AGTACCTAGCTATCCTGCAT
GAGTACGCAAACGGAGGCTC -> AGTACGCAAACGGAGGCTCT
GAGTCTTCCAGAGGGTGGCC -> AGTCTTCCAGAGGGTGGCCA
GAGTGAGTTGACGGTGTAGA -> AGTGAGTTGACGGTGTAGAG
GAGTTGAAGCGCCCGAGAGT -> AGTTGAAGCGCCCGAGAGTG
GAGTTGACGGTGTAGAGAGA -> AGTTGACGGTGTAGAGAGAT
GATAAATACGTGCGCACGTC -> ATAAATACGTGCGCACGTCA
GATAATTTGAATTATGATGT -> ATAATTTGAATTATGATGTA
GATAGCCAACGCAGGCCTTT -> ATAGCCAACGCAGGCCTTTT
GATCAAGCTGCGAGTCTTCC -> ATCAAGCTGCGAGTCTTCCA
GATCAATTCTTACGACCAAC -> ATCAATTCTTACGACCAACG
GATCCCATATTAGGGCGTGC -> ATCCCATATTAGGGCGTGCT
GATCCCCTCGTTCCACGCCG -> ATCCCCTCGTTCCACGCCGT
GATCGCCGCATTCACTCGGT -> ATCGCCGCATTCACTCGGTA
GATGATAAATACGTGCGCAC -> ATGATAAATACGTGCGCACG
GATGCAAGTCGGGCAGTAGA -> ATGCAAGTCGGGCAGTAGAG
GATGCATGCCTCTTAAGTTG -> ATGCATGCCTCTTAAGTTGA
GATGCTTCCAAAGGCCAGGC -> ATGCTTCCAAAGGCCAGGCT
GATGTAGAGATAGCCAACGC -> ATGTAGAGATAGCCAACGCA
GATTAGCAGTTGATTTCGCG -> ATTAGCAGTTGATTTCGCGA
GATTATCACCTCGCTTCGAC -> ATTATCACCTCGCTTCGACC
GATTCGCCGCACGTACGAGT -> ATTCGCCGCACGTACGAGTA
GATTGAGCGACAACAAAGCC -> ATTGAGCGACAACAAAGCCC
GATTGATTAGCAGTTGATTT -> ATTGATTAGCAGTTGATTTC
GATTGCACGGGGGCAGCAAG -> ATTGCACGGGGGCAGCAAGG
GATTGCTACAAATGTCCACC -> ATTGCTACAAATGTCCACCA
GATTTAGATTGCACGGGGGC -> ATTTAGATTGCACGGGGGCA
GATTTCGCGATCCCCTCGTT -> ATTTCGCGATCCCCTCGTTC
GCAAACGGAGGCTCTAGCGA -> CAAACGGAGGCTCTAGCGAA
GCAAACTTGCTGAACATTAT -> CAAACTTGCTGAACATTATT
GCAAGGTAGCTTACTATCTC -> CAAGGTAGCTTACTATCTCC
GCAAGTCGGGCAGTAGAGGG -> CAAGTCGGGCAGTAGAGGGG
GCACCGAATGGGATGCAAGT -> CACCGAATGGGATGCAAGTC
GCACGGGGGCAGCAAGGTAG -> CACGGGGGCAGCAAGGTAGC
GCACGTACGAGTACCTAGCT -> CACGTACGAGTACCTAGCTA
GCACGTCAGCCTATTCTTAC -> CACGTCAGCCTATTCTTACC
GCAGACTCACTATACACAAA -> CAGACTCACTATACACAAAA
GCAGCAAGGTAGCTTACTAT -> CAGCAAGGTAGCTTACTATC
GCAGCCCCATGAGTACGCAA -> CAGCCCCATGAGTACGCAAA
GCAGGATGCATGCCTCTTAA -> CAGGATGCATGCCTCTTAAG
GCAGGCCTTTTGATTGATTA -> CAGGCCTTTTGATTGATTAG
GCAGGGGGTGTGTGCAGACT -> CAGGGGGTGTGTGCAGACTC
GCAGTAAACTAGGTCGGACC -> CAGTAAACTAGGTCGGACCG
GCAGTAGAGGGGCAGTAAAC -> CAGTAGAGGGGCAGTAAACT
GCAGTGACTTGGGAAGAAGA -> CAGTGACTTGGGAAGAAGAT
GCAGTTGATTTCGCGATCCC -> CAGTTGATTTCGCGATCCCC
GCATACGACGAATTCTAGAG -> CATACGACGAATTCTAGAGA
GCATCGACTAGTGGATCCCA -> CATCGACTAGTGGATCCCAT
GCATCTCTACGGTGTCGTAG -> CATCTCTACGGTGTCGTAGA
GCATGAACCTTTGCATCGAC -> CATGAACCTTTGCATCGACT
GCATGATCAAGCTGCGAGTC -> CATGATCAAGCTGCGAGTCT
GCATGCCTCTTAAGTTGAGA -> CATGCCTCTTAAGTTGAGAG
GCATTCACTCGGTAAGCAGC -> CATTCACTCGGTAAGCAGCC
GCCAACCACTGTTCAAGTTC -> CCAACCACTGTTCAAGTTCG
GCCAACGCAGGCCTTTTGAT -> CCAACGCAGGCCTTTTGATT
GCCACAGGCAGGATGCATGC -> CCACAGGCAGGATGCATGCC
GCCAGGCTATGGCTGCATAC -> CCAGGCTATGGCTGCATACG
GCCATGCTTCCGAATGGCTG -> CCATGCTTCCGAATGGCTGA
GCCCACTTGAGGTCGGGGTA -> CCCACTTGAGGTCGGGGTAC
GCCCCATGAGTACGCAAACG -> CCCCATGAGTACGCAAACGG
GCCCGAGAGTGAGTTGACGG -> CCCGAGAGTGAGTTGACGGT
GCCCGGATAATTTGAATTAT -> CCCGGATAATTTGAATTATG
GCCCTAAAACACCCTGGTGG -> CCCTAAAACACCCTGGTGGA
GCCCTGCGCATGAACCTTTG -> CCCTGCGCATGAACCTTTGC
GCCGAAGTGCGTAGCGCCAA -> CCGAAGTGCGTAGCGCCAAC
GCCGCACGTACGAGTACCTA -> CCGCACGTACGAGTACCTAG
GCCGCATTCACTCGGTAAGC -> CCGCATTCACTCGGTAAGCA
GCCGTAGGACGCACCGAATG -> CCGTAGGACGCACCGAATGG
GCCTATTCTTACCAGACACG -> CCTATTCTTACCAGACACGT
GCCTCTTAAGTTGAGAGGTT -> CCTCTTAAGTTGAGAGGTTA
GCCTTGGCCGAAGTGCGTAG -> CCTTGGCCGAAGTGCGTAGC
GCCTTTTGATTGATTAGCAG -> CCTTTTGATTGATTAGCAGT
GCGAACCTGGCCCTGCGCAT -> CGAACCTGGCCCTGCGCATG
GCGACAACAAAGCCCGGATA -> CGACAACAAAGCCCGGATAA
GCGAGATCAATTCTTACGAC -> CGAGATCAATTCTTACGACC
GCGAGTCTTCCAGAGGGTGG -> CGAGTCTTCCAGAGGGTGGC
GCGATCCCCTCGTTCCACGC -> CGATCCCCTCGTTCCACGCC
GCGCACGTCAGCCTATTCTT -> CGCACGTCAGCCTATTCTTA
GCGCATGAACCTTTGCATCG -> CGCATGAACCTTTGCATCGA
GCGCCAACCACTGTTCAAGT -> CGCCAACCACTGTTCAAGTT
GCGCCCACTTGAGGTCGGGG -> CGCCCACTTGAGGTCGGGGT
GCGCCCGAGAGTGAGTTGAC -> CGCCCGAGAGTGAGTTGACG
GCGGGGATTCGCCGCACGTA -> CGGGGATTCGCCGCACGTAC
GCGTAGCGCCAACCACTGTT -> CGTAGCGCCAACCACTGTTC
GCGTGCTTGCTGGCCATGCT -> CGTGCTTGCTGGCCATGCTT
GCTACAAATGTCCACCAAAT -> CTACAAATGTCCACCAAATT
GCTAGGCGGGGATTCGCCGC -> CTAGGCGGGGATTCGCCGCA
GCTATCCTGCATCTCTACGG -> CTATCCTGCATCTCTACGGT
GCTATGGCTGCATACGACGA -> CTATGGCTGCATACGACGAA
GCTCAATGAGTACCAATGGC -> CTCAATGAGTACCAATGGCT
GCTCACGGGATTTAGATTGC -> CTCACGGGATTTAGATTGCA
GCTCTAGCGAACCTGGCCCT -> CTCTAGCGAACCTGGCCCTG
GCTCTATTGAGAGCATGATC -> CTCTATTGAGAGCATGATCA
GCTGAACATTATTAGGCGAG -> CTGAACATTATTAGGCGAGA
GCTGACATAAGCAGGGGGTG -> CTGACATAAGCAGGGGGTGT
GCTGCATACGACGAATTCTA -> CTGCATACGACGAATTCTAG
GCTGCGAGTCTTCCAGAGGG -> CTGCGAGTCTTCCAGAGGGT
GCTGGATTGCTACAAATGTC -> CTGGATTGCTACAAATGTCC
GCTGGCCATGCTTCCGAATG -> CTGGCCATGCTTCCGAATGG
GCTGGTCACCCGCTGGATTG -> CTGGTCACCCGCTGGATTGC
GCTTACTATCTCCGTGTGCG -> CTTACTATCTCCGTGTGCGC
GCTTCCAAAGGCCAGGCTAT -> CTTCCAAAGGCCAGGCTATG
GCTTCCGAATGGCTGACATA -> CTTCCGAATGGCTGACATAA
GCTTCGACCGAGCAGTGACT -> CTTCGACCGAGCAGTGACTT
GCTTGCTGGCCATGCTTCCG -> CTTGCTGGCCATGCTTCCGA
GGAAGAAGATCGCCGCATTC -> GAAGAAGATCGCCGCATTCA
GGAATCATTAGGGAGGTTTC -> GAATCATTAGGGAGGTTTCT
GGACCGCCCTAAAACACCCT -> GACCGCCCTAAAACACCCTG
GGACGCACCGAATGGGATGC -> GACGCACCGAATGGGATGCA
GGAGGCTCTAGCGAACCTGG -> GAGGCTCTAGCGAACCTGGC
GGAGGTTTCTCGACTGGTTG -> GAGGTTTCTCGACTGGTTGC
GGATAATTTGAATTATGATG -> GATAATTTGAATTATGATGT
GGATCCCATATTAGGGCGTG -> GATCCCATATTAGGGCGTGC
GGATGCAAGTCGGGCAGTAG -> GATGCAAGTCGGGCAGTAGA
GGATGCATGCCTCTTAAGTT -> GATGCATGCCTCTTAAGTTG
GGATTCGCCGCACGTACGAG -> GATTCGCCGCACGTACGAGT
GGATTGCTACAAATGTCCAC -> GATTGCTACAAATGTCCACC
GGATTTAGATTGCACGGGGG -> GATTTAGATTGCACGGGGGC
GGCAGCAAGGTAGCTTACTA -> GCAGCAAGGTAGCTTACTAT
GGCAGGATGCATGCCTCTTA -> GCAGGATGCATGCCTCTTAA
GGCAGTAAACTAGGTCGGAC -> GCAGTAAACTAGGTCGGACC
GGCAGTAGAGGGGCAGTAAA -> GCAGTAGAGGGGCAGTAAAC
GGCCACAGGCAGGATGCATG -> GCCACAGGCAGGATGCATGC
GGCCAGGCTATGGCTGCATA -> GCCAGGCTATGGCTGCATAC
GGCCATGCTTCCGAATGGCT -> GCCATGCTTCCGAATGGCTG
GGCCCTGCGCATGAACCTTT -> GCCCTGCGCATGAACCTTTG
GGCCGAAGTGCGTAGCGCCA -> GCCGAAGTGCGTAGCGCCAA
GGCCTTTTGATTGATTAGCA -> GCCTTTTGATTGATTAGCAG
GGCGAGATCAATTCTTACGA -> GCGAGATCAATTCTTACGAC
GGCGGGGATTCGCCGCACGT -> GCGGGGATTCGCCGCACGTA
GGCGTGCTTGCTGGCCATGC -> GCGTGCTTGCTGGCCATGCT
GGCTATGGCTGCATACGACG -> GCTATGGCTGCATACGACGA
GGCTCTAGCGAACCTGGCCC -> GCTCTAGCGAACCTGGCCCT
GGCTCTATTGAGAGCATGAT -> GCTCTATTGAGAGCATGATC
GGCTGACATAAGCAGGGGGT -> GCTGACATAAGCAGGGGGTG
GGCTGCATACGACGAATTCT -> GCTGCATACGACGAATTCTA
GGGAAGAAGATCGCCGCATT -> GGAAGAAGATCGCCGCATTC
GGGAGGTTTCTCGACTGGTT -> GGAGGTTTCTCGACTGGTTG
GGGATGCAAGTCGGGCAGTA -> GGATGCAAGTCGGGCAGTAG
GGGATTCGCCGCACGTACGA -> GGATTCGCCGCACGTACGAG
GGGATTTAGATTGCACGGGG -> GGATTTAGATTGCACGGGGG
GGGCAGCAAGGTAGCTTACT -> GGCAGCAAGGTAGCTTACTA
GGGCAGTAAACTAGGTCGGA -> GGCAGTAAACTAGGTCGGAC
GGGCAGTAGAGGGGCAGTAA -> GGCAGTAGAGGGGCAGTAAA
GGGCGTGCTTGCTGGCCATG -> GGCGTGCTTGCTGGCCATGC
GGGGATTCGCCGCACGTACG -> GGGATTCGCCGCACGTACGA
GGGGCAGCAAGGTAGCTTAC -> GGGCAGCAAGGTAGCTTACT
GGGGCAGTAAACTAGGTCGG -> GGGCAGTAAACTAGGTCGGA
GGGGGCAGCAAGGTAGCTTA -> GGGGCAGCAAGGTAGCTTAC
GGGGGTGTGTGCAGACTCAC -> GGGGTGTGTGCAGACTCACT
GGGGTGTGTGCAGACTCACT -> GGGTGTGTGCAGACTCACTA
GGGTGGCCACAGGCAGGATG -> GGTGGCCACAGGCAGGATGC
GGGTGTGTGCAGACTCACTA -> GGTGTGTGCAGACTCACTAT
GGTAAGCAGCCCCATGAGTA -> GTAAGCAGCCCCATGAGTAC
GGTAGCTTACTATCTCCGTG -> GTAGCTTACTATCTCCGTGT
GGTCACCCGCTGGATTGCTA -> GTCACCCGCTGGATTGCTAC
GGTCGGACCGCCCTAAAACA -> GTCGGACCGCCCTAAAACAC
GGTCTCCAACGCTCACGGGA -> GTCTCCAACGCTCACGGGAT
GGTGGAATCATTAGGGAGGT -> GTGGAATCATTAGGGAGGTT
GGTGGCCACAGGCAGGATGC -> GTGGCCACAGGCAGGATGCA
GGTGTAGAGAGATGATAAAT -> GTGTAGAGAGATGATAAATA
GGTGTCGTAGAAGACGATGC -> GTGTCGTAGAAGACGATGCT
GGTGTGTGCAGACTCACTAT -> GTGTGTGCAGACTCACTATA
GGTTACGCTAGGCGGGGATT -> GTTACGCTAGGCGGGGATTC
GGTTGCAAACTTGCTGAACA -> GTTGCAAACTTGCTGAACAT
GGTTTCTCGACTGGTTGCAA -> GTTTCTCGACTGGTTGCAAA
GTAAACTAGGTCGGACCGCC -> TAAACTAGGTCGGACCGCCC
GTAAGCAGCCCCATGAGTAC -> TAAGCAGCCCCATGAGTACG
GTACCAATGGCTCTATTGAG -> TACCAATGGCTCTATTGAGA
GTACCTAGCTATCCTGCATC -> TACCTAGCTATCCTGCATCT
GTACGAGTACCTAGCTATCC -> TACGAGTACCTAGCTATCCT
GTACGCAAACGGAGGCTCTA -> TACGCAAACGGAGGCTCTAG
GTAGAAGACGATGCTTCCAA -> TAGAAGACGATGCTTCCAAA
GTAGAGAGATGATAAATACG -> TAGAGAGATGATAAATACGT
GTAGAGATAGCCAACGCAGG -> TAGAGATAGCCAACGCAGGC
GTAGAGGGGCAGTAAACTAG -> TAGAGGGGCAGTAAACTAGG
GTAGCGCCAACCACTGTTCA -> TAGCGCCAACCACTGTTCAA
GTAGCTTACTATCTCCGTGT -> TAGCTTACTATCTCCGTGTG
GTAGGACGCACCGAATGGGA -> TAGGACGCACCGAATGGGAT
GTATGACCGGTCTCCAACGC -> TATGACCGGTCTCCAACGCT
GTCACCCGCTGGATTGCTAC -> TCACCCGCTGGATTGCTACA
GTCAGCCTATTCTTACCAGA -> TCAGCCTATTCTTACCAGAC
GTCCACCAAATTATAGATTG -> TCCACCAAATTATAGATTGA
GTCGCCTTGGCCGAAGTGCG -> TCGCCTTGGCCGAAGTGCGT
GTCGGACCGCCCTAAAACAC -> TCGGACCGCCCTAAAACACC
GTCGGGCAGTAGAGGGGCAG -> TCGGGCAGTAGAGGGGCAGT
GTCGTAGAAGACGATGCTTC -> TCGTAGAAGACGATGCTTCC
GTCTCCAACGCTCACGGGAT -> TCTCCAACGCTCACGGGATT
GTCTTCCAGAGGGTGGCCAC -> TCTTCCAGAGGGTGGCCACA
GTGACTTGGGAAGAAGATCG -> TGACTTGGGAAGAAGATCGC
GTGAGTTGACGGTGTAGAGA -> TGAGTTGACGGTGTAGAGAG
GTGCAGACTCACTATACACA -> TGCAGACTCACTATACACAA
GTGCGCACGTCAGCCTATTC -> TGCGCACGTCAGCCTATTCT
GTGCGCCCACTTGAGGTCGG -> TGCGCCCACTTGAGGTCGGG
GTGCGTAGCGCCAACCACTG -> TGCGTAGCGCCAACCACTGT
GTGCTTGCTGGCCATGCTTC -> TGCTTGCTGGCCATGCTTCC
GTGGAATCATTAGGGAGGTT -> TGGAATCATTAGGGAGGTTT
GTGGATCCCATATTAGGGCG -> TGGATCCCATATTAGGGCGT
GTGGCCACAGGCAGGATGCA -> TGGCCACAGGCAGGATGCAT
GTGTAGAGAGATGATAAATA -> TGTAGAGAGATGATAAATAC
GTGTCGTAGAAGACGATGCT -> TGTCGTAGAAGACGATGCTT
GTGTGCAGACTCACTATACA -> TGTGCAGACTCACTATACAC
GTGTGCGCCCACTTGAGGTC -> TGTGCGCCCACTTGAGGTCG
GTGTGTGCAGACTCACTATA -> TGTGTGCAGACTCACTATAC
GTTACGCTAGGCGGGGATTC -> TTACGCTAGGCGGGGATTCG
GTTCAAGTTCGCTGGTCACC -> TTCAAGTTCGCTGGTCACCC
GTTCCACGCCGTAGGACGCA -> TTCCACGCCGTAGGACGCAC
GTTCGCTGGTCACCCGCTGG -> TTCGCTGGTCACCCGCTGGA
GTTGAAGCGCCCGAGAGTGA -> TTGAAGCGCCCGAGAGTGAG
GTTGACGGTGTAGAGAGATG -> TTGACGGTGTAGAGAGATGA
GTTGAGAGGTTACGCTAGGC -> TTGAGAGGTTACGCTAGGCG
GTTGATTTCGCGATCCCCTC -> TTGATTTCGCGATCCCCTCG
GTTGCAAACTTGCTGAACAT -> TTGCAAACTTGCTGAACATT
GTTTCTCGACTGGTTGCAAA -> TTTCTCGACTGGTTGCAAAC
TAAAACACCCTGGTGGAATC -> AAAACACCCTGGTGGAATCA
TAAACTAGGTCGGACCGCCC -> AAACTAGGTCGGACCGCCCT
TAAATACGTGCGCACGTCAG -> AAATACGTGCGCACGTCAGC
TAAGCAGCCCCATGAGTACG -> AAGCAGCCCCATGAGTACGC
TAAGCAGGGGGTGTGTGCAG -> AAGCAGGGGGTGTGTGCAGA
TAAGTTGAGAGGTTACGCTA -> AAGTTGAGAGGTTACGCTAG
TAATTTGAATTATGATGTAG -> AATTTGAATTATGATGTAGA
TACAAATGTCCACCAAATTA -> ACAAATGTCCACCAAATTAT
TACACAAAACCCCTCTTGCT -> ACACAAAACCCCTCTTGCTC
TACCAATGGCTCTATTGAGA -> ACCAATGGCTCTATTGAGAG
TACCAGACACGTATGACCGG -> ACCAGACACGTATGACCGGT
TACCTAGCTATCCTGCATCT -> ACCTAGCTATCCTGCATCTC
TACGACCAACGAGTTGAAGC -> ACGACCAACGAGTTGAAGCG
TACGACGAATTCTAGAGACT -> ACGACGAATTCTAGAGACTA
TACGAGTACCTAGCTATCCT -> ACGAGTACCTAGCTATCCTG
TACGCAAACGGAGGCTCTAG -> ACGCAAACGGAGGCTCTAGC
TACGCTAGGCGGGGATTCGC -> ACGCTAGGCGGGGATTCGCC
TACGGTGTCGTAGAAGACGA -> ACGGTGTCGTAGAAGACGAT
TACGTGCGCACGTCAGCCTA -> ACGTGCGCACGTCAGCCTAT
TACTATCTCCGTGTGCGCCC -> ACTATCTCCGTGTGCGCCCA
TAGAAGACGATGCTTCCAAA -> AGAAGACGATGCTTCCAAAG
TAGAGACTATCCAATTCTCA -> AGAGACTATCCAATTCTCAC
TAGAGAGATGATAAATACGT -> AGAGAGATGATAAATACGTG
TAGAGATAGCCAACGCAGGC -> AGAGATAGCCAACGCAGGCC
TAGAGGGGCAGTAAACTAGG -> AGAGGGGCAGTAAACTAGGT
TAGATTGAGCGACAACAAAG -> AGATTGAGCGACAACAAAGC
TAGATTGCACGGGGGCAGCA -> AGATTGCACGGGGGCAGCAA
TAGCAGTTGATTTCGCGATC -> AGCAGTTGATTTCGCGATCC
TAGCCAACGCAGGCCTTTTG -> AGCCAACGCAGGCCTTTTGA
TAGCGAACCTGGCCCTGCGC -> AGCGAACCTGGCCCTGCGCA
TAGCGCCAACCACTGTTCAA -> AGCGCCAACCACTGTTCAAG
TAGCTATCCTGCATCTCTAC -> AGCTATCCTGCATCTCTACG
TAGCTTACTATCTCCGTGTG -> AGCTTACTATCTCCGTGTGC
TAGGACGCACCGAATGGGAT -> AGGACGCACCGAATGGGATG
TAGGCGAGATCAATTCTTAC -> AGGCGAGATCAATTCTTACG
TAGGCGGGGATTCGCCGCAC -> AGGCGGGGATTCGCCGCACG
TAGGGAGGTTTCTCGACTGG -> AGGGAGGTTTCTCGACTGGT
TAGGGCGTGCTTGCTGGCCA -> AGGGCGTGCTTGCTGGCCAT
TAGGTCGGACCGCCCTAAAA -> AGGTCGGACCGCCCTAAAAC
TAGTCGCCTTGGCCGAAGTG -> AGTCGCCTTGGCCGAAGTGC
TAGTGGATCCCATATTAGGG -> AGTGGATCCCATATTAGGGC
TATACACAAAACCCCTCTTG -> ATACACAAAACCCCTCTTGC
TATAGATTGAGCGACAACAA -> ATAGATTGAGCGACAACAAA
TATAGTCGCCTTGGCCGAAG -> ATAGTCGCCTTGGCCGAAGT
TATCACCTCGCTTCGACCGA -> ATCACCTCGCTTCGACCGAG
TATCCAATTCTCACTATAGT -> ATCCAATTCTCACTATAGTC
TATCCTGCATCTCTACGGTG -> ATCCTGCATCTCTACGGTGT
TATCTCCGTGTGCGCCCACT -> ATCTCCGTGTGCGCCCACTT
TATGACCGGTCTCCAACGCT -> ATGACCGGTCTCCAACGCTC
TATGATGTAGAGATAGCCAA -> ATGATGTAGAGATAGCCAAC
TATGGCTGCATACGACGAAT -> ATGGCTGCATACGACGAATT
TATTAGGCGAGATCAATTCT -> ATTAGGCGAGATCAATTCTT
TATTAGGGCGTGCTTGCTGG -> ATTAGGGCGTGCTTGCTGGC
TATTCTTACCAGACACGTAT -> ATTCTTACCAGACACGTATG
TATTGAGAGCATGATCAAGC -> ATTGAGAGCATGATCAAGCT
TCAAGCTGCGAGTCTTCCAG -> CAAGCTGCGAGTCTTCCAGA
TCAAGTTCGCTGGTCACCCG -> CAAGTTCGCTGGTCACCCGC
TCAATGAGTACCAATGGCTC -> CAATGAGTACCAATGGCTCT
TCAATTCTTACGACCAACGA -> CAATTCTTACGACCAACGAG
TCACCCGCTGGATTGCTACA -> CACCCGCTGGATTGCTACAA
TCACCTCGCTTCGACCGAGC -> CACCTCGCTTCGACCGAGCA
TCACGGGATTTAGATTGCAC -> CACGGGATTTAGATTGCACG
TCACTATACACAAAACCCCT -> CACTATACACAAAACCCCTC
TCACTATAGTCGCCTTGGCC -> CACTATAGTCGCCTTGGCCG
TCACTCGGTAAGCAGCCCCA -> CACTCGGTAAGCAGCCCCAT
TCAGCCTATTCTTACCAGAC -> CAGCCTATTCTTACCAGACA
TCATTAGGGAGGTTTCTCGA -> CATTAGGGAGGTTTCTCGAC
TCCAAAGGCCAGGCTATGGC -> CCAAAGGCCAGGCTATGGCT
TCCAACGCTCACGGGATTTA -> CCAACGCTCACGGGATTTAG
TCCAATTCTCACTATAGTCG -> CCAATTCTCACTATAGTCGC
TCCACCAAATTATAGATTGA -> CCACCAAATTATAGATTGAG
TCCACGCCGTAGGACGCACC -> CCACGCCGTAGGACGCACCG
TCCAGAGGGTGGCCACAGGC -> CCAGAGGGTGGCCACAGGCA
TCCCATATTAGGGCGTGCTT -> CCCATATTAGGGCGTGCTTG
TCCCCTCGTTCCACGCCGTA -> CCCCTCGTTCCACGCCGTAG
TCCGAATGGCTGACATAAGC -> CCGAATGGCTGACATAAGCA
TCCGTGTGCGCCCACTTGAG -> CCGTGTGCGCCCACTTGAGG
TCCTGCATCTCTACGGTGTC -> CCTGCATCTCTACGGTGTCG
TCGACCGAGCAGTGACTTGG -> CGACCGAGCAGTGACTTGGG
TCGACTAGTGGATCCCATAT -> CGACTAGTGGATCCCATATT
TCGACTGGTTGCAAACTTGC -> CGACTGGTTGCAAACTTGCT
TCGCCGCACGTACGAGTACC -> CGCCGCACGTACGAGTACCT
TCGCCGCATTCACTCGGTAA -> CGCCGCATTCACTCGGTAAG
TCGCCTTGGCCGAAGTGCGT -> CGCCTTGGCCGAAGTGCGTA
TCGCGATCCCCTCGTTCCAC -> CGCGATCCCCTCGTTCCACG
TCGCTGGTCACCCGCTGGAT -> CGCTGGTCACCCGCTGGATT
TCGCTTCGACCGAGCAGTGA -> CGCTTCGACCGAGCAGTGAC
TCGGACCGCCCTAAAACACC -> CGGACCGCCCTAAAACACCC
TCGGGCAGTAGAGGGGCAGT -> CGGGCAGTAGAGGGGCAGTA
TCGGTAAGCAGCCCCATGAG -> CGGTAAGCAGCCCCATGAGT
TCGTAGAAGACGATGCTTCC -> CGTAGAAGACGATGCTTCCA
TCGTTCCACGCCGTAGGACG -> CGTTCCACGCCGTAGGACGC
TCTACGGTGTCGTAGAAGAC -> CTACGGTGTCGTAGAAGACG
TCTAGAGACTATCCAATTCT -> CTAGAGACTATCCAATTCTC
TCTAGCGAACCTGGCCCTGC -> CTAGCGAACCTGGCCCTGCG
TCTATTGAGAGCATGATCAA -> CTATTGAGAGCATGATCAAG
TCTCACTATAGTCGCCTTGG -> CTCACTATAGTCGCCTTGGC
TCTCCAACGCTCACGGGATT -> CTCCAACGCTCACGGGATTT
TCTCCGTGTGCGCCCACTTG -> CTCCGTGTGCGCCCACTTGA
TCTCGACTGGTTGCAAACTT -> CTCGACTGGTTGCAAACTTG
TCTCTACGGTGTCGTAGAAG -> CTCTACGGTGTCGTAGAAGA
TCTTAAGTTGAGAGGTTACG -> CTTAAGTTGAGAGGTTACGC
TCTTACCAGACACGTATGAC -> CTTACCAGACACGTATGACC
TCTTACGACCAACGAGTTGA -> CTTACGACCAACGAGTTGAA
TCTTCCAGAGGGTGGCCACA -> CTTCCAGAGGGTGGCCACAG
TCTTGCTCAATGAGTACCAA -> CTTGCTCAATGAGTACCAAT
TGAACATTATTAGGCGAGAT -> GAACATTATTAGGCGAGATC
TGAACCTTTGCATCGACTAG -> GAACCTTTGCATCGACTAGT
TGAAGCGCCCGAGAGTGAGT -> GAAGCGCCCGAGAGTGAGTT
TGAATTATGATGTAGAGATA -> GAATTATGATGTAGAGATAG
TGACATAAGCAGGGGGTGTG -> GACATAAGCAGGGGGTGTGT
TGACCGGTCTCCAACGCTCA -> GACCGGTCTCCAACGCTCAC
TGACGGTGTAGAGAGATGAT -> GACGGTGTAGAGAGATGATA
TGACTTGGGAAGAAGATCGC -> GACTTGGGAAGAAGATCGCC
TGAGAGCATGATCAAGCTGC -> GAGAGCATGATCAAGCTGCG
TGAGAGGTTACGCTAGGCGG -> GAGAGGTTACGCTAGGCGGG
TGAGCGACAACAAAGCCCGG -> GAGCGACAACAAAGCCCGGA
TGAGTACCAATGGCTCTATT -> GAGTACCAATGGCTCTATTG
TGAGTACGCAAACGGAGGCT -> GAGTACGCAAACGGAGGCTC
TGAGTTGACGGTGTAGAGAG -> GAGTTGACGGTGTAGAGAGA
TGATAAATACGTGCGCACGT -> GATAAATACGTGCGCACGTC
TGATCAAGCTGCGAGTCTTC -> GATCAAGCTGCGAGTCTTCC
TGATGTAGAGATAGCCAACG -> GATGTAGAGATAGCCAACGC
TGATTAGCAGTTGATTTCGC -> GATTAGCAGTTGATTTCGCG
TGATTGATTAGCAGTTGATT -> GATTGATTAGCAGTTGATTT
TGATTTCGCGATCCCCTCGT -> GATTTCGCGATCCCCTCGTT
TGCAAACTTGCTGAACATTA -> GCAAACTTGCTGAACATTAT
TGCAAGTCGGGCAGTAGAGG -> GCAAGTCGGGCAGTAGAGGG
TGCACGGGGGCAGCAAGGTA -> GCACGGGGGCAGCAAGGTAG
TGCAGACTCACTATACACAA -> GCAGACTCACTATACACAAA
TGCATACGACGAATTCTAGA -> GCATACGACGAATTCTAGAG
TGCATCGACTAGTGGATCCC -> GCATCGACTAGTGGATCCCA
TGCATCTCTACGGTGTCGTA -> GCATCTCTACGGTGTCGTAG
TGCATGCCTCTTAAGTTGAG -> GCATGCCTCTTAAGTTGAGA
TGCCTCTTAAGTTGAGAGGT -> GCCTCTTAAGTTGAGAGGTT
TGCGAGTCTTCCAGAGGGTG -> GCGAGTCTTCCAGAGGGTGG
TGCGCACGTCAGCCTATTCT -> GCGCACGTCAGCCTATTCTT
TGCGCATGAACCTTTGCATC -> GCGCATGAACCTTTGCATCG
TGCGCCCACTTGAGGTCGGG -> GCGCCCACTTGAGGTCGGGG
TGCGTAGCGCCAACCACTGT -> GCGTAGCGCCAACCACTGTT
TGCTACAAATGTCCACCAAA -> GCTACAAATGTCCACCAAAT
TGCTCAATGAGTACCAATGG -> GCTCAATGAGTACCAATGGC
TGCTGAACATTATTAGGCGA -> GCTGAACATTATTAGGCGAG
TGCTGGCCATGCTTCCGAAT -> GCTGGCCATGCTTCCGAATG
TGCTTCCAAAGGCCAGGCTA -> GCTTCCAAAGGCCAGGCTAT
TGCTTCCGAATGGCTGACAT -> GCTTCCGAATGGCTGACATA
TGCTTGCTGGCCATGCTTCC -> GCTTGCTGGCCATGCTTCCG
TGGAATCATTAGGGAGGTTT -> GGAATCATTAGGGAGGTTTC
TGGATCCCATATTAGGGCGT -> GGATCCCATATTAGGGCGTG
TGGATTGCTACAAATGTCCA -> GGATTGCTACAAATGTCCAC
TGGCCACAGGCAGGATGCAT -> GGCCACAGGCAGGATGCATG
TGGCCATGCTTCCGAATGGC -> GGCCATGCTTCCGAATGGCT
TGGCCCTGCGCATGAACCTT -> GGCCCTGCGCATGAACCTTT
TGGCCGAAGTGCGTAGCGCC -> GGCCGAAGTGCGTAGCGCCA
TGGCTCTATTGAGAGCATGA -> GGCTCTATTGAGAGCATGAT
TGGCTGACATAAGCAGGGGG -> GGCTGACATAAGCAGGGGGT
TGGCTGCATACGACGAATTC -> GGCTGCATACGACGAATTCT
TGGGAAGAAGATCGCCGCAT -> GGGAAGAAGATCGCCGCATT
TGGGATGCAAGTCGGGCAGT -> GGGATGCAAGTCGGGCAGTA
TGGTCACCCGCTGGATTGCT -> GGTCACCCGCTGGATTGCTA
TGGTGGAATCATTAGGGAGG -> GGTGGAATCATTAGGGAGGT
TGGTTGCAAACTTGCTGAAC -> GGTTGCAAACTTGCTGAACA
TGTAGAGAGATGATAAATAC -> GTAGAGAGATGATAAATACG
TGTAGAGATAGCCAACGCAG -> GTAGAGATAGCCAACGCAGG
TGTCCACCAAATTATAGATT -> GTCCACCAAATTATAGATTG
TGTCGTAGAAGACGATGCTT -> GTCGTAGAAGACGATGCTTC
TGTGCAGACTCACTATACAC -> GTGCAGACTCACTATACACA
TGTGCGCCCACTTGAGGTCG -> GTGCGCCCACTTGAGGTCGG
TGTGTGCAGACTCACTATAC -> GTGTGCAGACTCACTATACA
TGTTCAAGTTCGCTGGTCAC -> GTTCAAGTTCGCTGGTCACC
TTAAGTTGAGAGGTTACGCT -> TAAGTTGAGAGGTTACGCTA
TTACCAGACACGTATGACCG -> TACCAGACACGTATGACCGG
TTACGACCAACGAGTTGAAG -> TACGACCAACGAGTTGAAGC
TTACGCTAGGCGGGGATTCG -> TACGCTAGGCGGGGATTCGC
TTACTATCTCCGTGTGCGCC -> TACTATCTCCGTGTGCGCCC
TTAGATTGCACGGGGGCAGC -> TAGATTGCACGGGGGCAGCA
TTAGCAGTTGATTTCGCGAT -> TAGCAGTTGATTTCGCGATC
TTAGGCGAGATCAATTCTTA -> TAGGCGAGATCAATTCTTAC
TTAGGGAGGTTTCTCGACTG -> TAGGGAGGTTTCTCGACTGG
TTAGGGCGTGCTTGCTGGCC -> TAGGGCGTGCTTGCTGGCCA
TTATAGATTGAGCGACAACA -> TATAGATTGAGCGACAACAA
TTATCACCTCGCTTCGACCG -> TATCACCTCGCTTCGACCGA
TTATGATGTAGAGATAGCCA -> TATGATGTAGAGATAGCCAA
TTATTAGGCGAGATCAATTC -> TATTAGGCGAGATCAATTCT
TTCAAGTTCGCTGGTCACCC -> TCAAGTTCGCTGGTCACCCG
TTCACTCGGTAAGCAGCCCC -> TCACTCGGTAAGCAGCCCCA
TTCCAAAGGCCAGGCTATGG -> TCCAAAGGCCAGGCTATGGC
TTCCACGCCGTAGGACGCAC -> TCCACGCCGTAGGACGCACC
TTCCAGAGGGTGGCCACAGG -> TCCAGAGGGTGGCCACAGGC
TTCCGAATGGCTGACATAAG -> TCCGAATGGCTGACATAAGC
TTCGACCGAGCAGTGACTTG -> TCGACCGAGCAGTGACTTGG
TTCGCCGCACGTACGAGTAC -> TCGCCGCACGTACGAGTACC
TTCGCGATCCCCTCGTTCCA -> TCGCGATCCCCTCGTTCCAC
TTCGCTGGTCACCCGCTGGA -> TCGCTGGTCACCCGCTGGAT
TTCTAGAGACTATCCAATTC -> TCTAGAGACTATCCAATTCT
TTCTCACTATAGTCGCCTTG -> TCTCACTATAGTCGCCTTGG
TTCTCGACTGGTTGCAAACT -> TCTCGACTGGTTGCAAACTT
TTCTTACCAGACACGTATGA -> TCTTACCAGACACGTATGAC
TTCTTACGACCAACGAGTTG -> TCTTACGACCAACGAGTTGA
TTGAAGCGCCCGAGAGTGAG -> TGAAGCGCCCGAGAGTGAGT
TTGAATTATGATGTAGAGAT -> TGAATTATGATGTAGAGATA
TTGACGGTGTAGAGAGATGA -> TGACGGTGTAGAGAGATGAT
TTGAGAGCATGATCAAGCTG -> TGAGAGCATGATCAAGCTGC
TTGAGAGGTTACGCTAGGCG -> TGAGAGGTTACGCTAGGCGG
TTGAGCGACAACAAAGCCCG -> TGAGCGACAACAAAGCCCGG
TTGATTAGCAGTTGATTTCG -> TGATTAGCAGTTGATTTCGC
TTGATTGATTAGCAGTTGAT -> TGATTGATTAGCAGTTGATT
TTGATTTCGCGATCCCCTCG -> TGATTTCGCGATCCCCTCGT
TTGCAAACTTGCTGAACATT -> TGCAAACTTGCTGAACATTA
TTGCACGGGGGCAGCAAGGT -> TGCACGGGGGCAGCAAGGTA
TTGCATCGACTAGTGGATCC -> TGCATCGACTAGTGGATCCC
TTGCTACAAATGTCCACCAA -> TGCTACAAATGTCCACCAAA
TTGCTCAATGAGTACCAATG -> TGCTCAATGAGTACCAATGG
TTGCTGAACATTATTAGGCG -> TGCTGAACATTATTAGGCGA
TTGCTGGCCATGCTTCCGAA -> TGCTGGCCATGCTTCCGAAT
TTGGCCGAAGTGCGTAGCGC -> TGGCCGAAGTGCGTAGCGCC
TTGGGAAGAAGATCGCCGCA -> TGGGAAGAAGATCGCCGCAT
TTTAGATTGCACGGGGGCAG -> TTAGATTGCACGGGGGCAGC
TTTCGCGATCCCCTCGTTCC -> TTCGCGATCCCCTCGTTCCA
TTTCTCGACTGGTTGCAAAC -> TTCTCGACTGGTTGCAAACT
TTTGAATTATGATGTAGAGA -> TTGAATTATGATGTAGAGAT
TTTGATTGATTAGCAGTTGA -> TTGATTGATTAGCAGTTGAT
TTTGCATCGACTAGTGGATC -> TTGCATCGACTAGTGGATCC
TTTTGATTGATTAGCAGTTG -> TTTGATTGATTAGCAGTTGA