AAAAACCTGCA -> AAAACCTGCAT
AAAAAGTGGTC -> AAAAGTGGTCG
AAAAATCCCAA -> AAAATCCCAAG
AAAACCGTCAT -> AAACCGTCATG
AAAACCTGCAT -> AAACCTGCATC
AAAACTTTGTT -> AAACTTTGTTG
AAAAGTGGGAT -> AAAGTGGGATG
AAAAGTGGTCG -> AAAGTGGTCGT
AAAATAACTCA -> AAATAACTCAC
AAAATCCCAAG -> AAATCCCAAGA
AAAATGAGTAT -> AAATGAGTATC
AAAATTCAAGA -> AAATTCAAGAG
AAACATCGTGT -> AACATCGTGTG
AAACCGTCATG -> AACCGTCATGA
AAACCTATGTC -> AACCTATGTCC
AAACCTGCATC -> AACCTGCATCT
AAACTACCGTC -> AACTACCGTCC
AAACTTTGTTG -> AACTTTGTTGC
AAAGAGATGAG -> AAGAGATGAGG
AAAGATTTAAG -> AAGATTTAAGC
AAAGCAGCCTA -> AAGCAGCCTAG
AAAGCCAGAAC -> AAGCCAGAACG
AAAGCTTCTAA -> AAGCTTCTAAG
AAAGGTGGGCT -> AAGGTGGGCTG
AAAGTCCTAAC -> AAGTCCTAACC
AAAGTGGGATG -> AAGTGGGATGT
AAAGTGGTCGT -> AAGTGGTCGTT
AAATAAAGCAG -> AATAAAGCAGC
AAATAACTCAC -> AATAACTCACT
AAATAAGCAGC -> AATAAGCAGCC
AAATCCCAAGA -> AATCCCAAGAC
AAATGAAAATT -> AATGAAAATTC
AAATGAGTATC -> AATGAGTATCT
AAATGCATCGG -> AATGCATCGGT
AAATGTGAACC -> AATGTGAACCC
AAATTCAAGAG -> AATTCAAGAGA
AACAAGGATAA -> ACAAGGATAAA
AACACGGAGAG -> ACACGGAGAGG
AACACTACGGG -> ACACTACGGGA
AACAGATGTGG -> ACAGATGTGGT
AACATCGTGTG -> ACATCGTGTGT
AACATGAAAGC -> ACATGAAAGCT
AACCAACTCAT -> ACCAACTCATC
AACCATGCCCT -> ACCATGCCCTC
AACCCCGACCC -> ACCCCGACCCA
AACCCCGAGTA -> ACCCCGAGTAA
AACCCGACCAA -> ACCCGACCAAT
AACCGTCATGA -> ACCGTCATGAG
AACCGTTAAGC -> ACCGTTAAGCC
AACCTATGTCC -> ACCTATGTCCA
AACCTGCATCT -> ACCTGCATCTC
AACCTTACTGC -> ACCTTACTGCC
AACCTTTCCAC -> ACCTTTCCACC
AACGATTCATG -> ACGATTCATGT
AACGCACCTAC -> ACGCACCTACG
AACGGGTAGGC -> ACGGGTAGGCT
AACGGGTCATG -> ACGGGTCATGG
AACGTGAGGTT -> ACGTGAGGTTC
AACTACCGTCC -> ACTACCGTCCT
AACTCACTTGC -> ACTCACTTGCT
AACTCATCTGT -> ACTCATCTGTC
AACTGCGATAT -> ACTGCGATATA
AACTTGCATTG -> ACTTGCATTGA
AACTTTGTTGC -> ACTTTGTTGCT
AAGAACCCCGA -> AGAACCCCGAG
AAGACCTACGG -> AGACCTACGGG
AAGAGAACTTG -> AGAGAACTTGC
AAGAGATGAGG -> AGAGATGAGGC
AAGAGTTGCTT -> AGAGTTGCTTC
AAGATTTAAGC -> AGATTTAAGCC
AAGCAACCTTT -> AGCAACCTTTC
AAGCACGCTAT -> AGCACGCTATT
AAGCAGAGTTA -> AGCAGAGTTAG
AAGCAGCCGAG -> AGCAGCCGAGC
AAGCAGCCTAG -> AGCAGCCTAGG
AAGCCAGAACG -> AGCCAGAACGG
AAGCCAGGAAG -> AGCCAGGAAGC
AAGCCCGGGCT -> AGCCCGGGCTC
AAGCCTTGTAG -> AGCCTTGTAGA
AAGCGAAAAAG -> AGCGAAAAAGT
AAGCGACACCA -> AGCGACACCAT
AAGCGGCTGTT -> AGCGGCTGTTC
AAGCGTCCGCG -> AGCGTCCGCGT
AAGCTCAGCAC -> AGCTCAGCACG
AAGCTCATTAC -> AGCTCATTACC
AAGCTTAATAT -> AGCTTAATATG
AAGCTTCTAAG -> AGCTTCTAAGT
AAGGATAAATA -> AGGATAAATAA
AAGGCGCAAGT -> AGGCGCAAGTA
AAGGCGCGTTT -> AGGCGCGTTTA
AAGGTGGGCTG -> AGGTGGGCTGG
AAGTAACACGG -> AGTAACACGGA
AAGTAACCCCG -> AGTAACCCCGA
AAGTCCTAACC -> AGTCCTAACCT
AAGTCGCAATG -> AGTCGCAATGT
AAGTGCCCGTT -> AGTGCCCGTTC
AAGTGGACCAG -> AGTGGACCAGC
AAGTGGGATGT -> AGTGGGATGTG
AAGTGGGTGGG -> AGTGGGTGGGC
AAGTGGTCGTT -> AGTGGTCGTTA
AAGTTCAATGC -> AGTTCAATGCT
AAGTTTGACAT -> AGTTTGACATC
AATAAAAACCT -> ATAAAAACCTG
AATAAACATCG -> ATAAACATCGT
AATAAAGCAGC -> ATAAAGCAGCC
AATAAATGCAT -> ATAAATGCATC
AATAACTCACT -> ATAACTCACTT
AATAAGCAGCC -> ATAAGCAGCCG
AATAATTGGTT -> ATAATTGGTTA
AATAGAACATG -> ATAGAACATGA
AATAGCCATGA -> ATAGCCATGAG
AATAGTACGGA -> ATAGTACGGAT
AATATCTCTGA -> ATATCTCTGAG
AATATGAACGA -> ATATGAACGAT
AATCAGAAAAT -> ATCAGAAAATA
AATCCCAAGAC -> ATCCCAAGACC
AATCGCGTGTT -> ATCGCGTGTTT
AATGAAAATTC -> ATGAAAATTCA
AATGAGATTCG -> ATGAGATTCGT
AATGAGTATCT -> ATGAGTATCTT
AATGCATCGGT -> ATGCATCGGTC
AATGCCCGGCC -> ATGCCCGGCCC
AATGCCGTCAT -> ATGCCGTCATT
AATGCTGATGT -> ATGCTGATGTT
AATGGGTAGCG -> ATGGGTAGCGA
AATGTGAACCC -> ATGTGAACCCG
AATGTGGGAGA -> ATGTGGGAGAC
AATTAAGCGAC -> ATTAAGCGACA
AATTCAAGAGA -> ATTCAAGAGAA
AATTGAAGTGG -> ATTGAAGTGGA
AATTGAGTGGT -> ATTGAGTGGTT
AATTGATAACG -> ATTGATAACGT
AATTGGTTATT -> ATTGGTTATTG
AATTGTTTATG -> ATTGTTTATGC
AATTTGCATCC -> ATTTGCATCCT
AATTTGCGGAT -> ATTTGCGGATG
ACAACACTACG -> CAACACTACGG
ACAAGAACCCC -> CAAGAACCCCG
ACAAGCACGCT -> CAAGCACGCTA
ACAAGGATAAA -> CAAGGATAAAT
ACAATAGTACG -> CAATAGTACGG
ACAATTGATAA -> CAATTGATAAC
ACACCATTACG -> CACCATTACGA
ACACGGAGAGG -> CACGGAGAGGG
ACACTACGGGA -> CACTACGGGAG
ACACTTTATTC -> CACTTTATTCT
ACAGACTTAAG -> CAGACTTAAGC
ACAGATGTGGT -> CAGATGTGGTG
ACAGGTTAATA -> CAGGTTAATAT
ACAGTGTCGAC -> CAGTGTCGACA
ACATCCTTCTA -> CATCCTTCTAG
ACATCGATAAT -> CATCGATAATA
ACATCGGAGTG -> CATCGGAGTGG
ACATCGGTAGC -> CATCGGTAGCG
ACATCGTGTGT -> CATCGTGTGTT
ACATGAAAGCT -> CATGAAAGCTT
ACATTGACTCC -> CATTGACTCCT
ACCAACTCATC -> CCAACTCATCT
ACCAATTTGCA -> CCAATTTGCAT
ACCACCTGGTA -> CCACCTGGTAG
ACCAGCTATCG -> CCAGCTATCGT
ACCATCGGAGC -> CCATCGGAGCC
ACCATGCCCTC -> CCATGCCCTCA
ACCATTACGAG -> CCATTACGAGC
ACCCAGCTAAT -> CCCAGCTAATT
ACCCATACAGA -> CCCATACAGAC
ACCCCACGTGA -> CCCCACGTGAG
ACCCCCATCCC -> CCCCCATCCCA
ACCCCCGAGCA -> CCCCCGAGCAA
ACCCCGACCCA -> CCCCGACCCAT
ACCCCGAGTAA -> CCCCGAGTAAC
ACCCCTCACCG -> CCCCTCACCGA
ACCCGACCAAT -> CCCGACCAATT
ACCGACAGGTT -> CCGACAGGTTA
ACCGAGACCCA -> CCGAGACCCAG
ACCGAGTTTTG -> CCGAGTTTTGC
ACCGCTTGACT -> CCGCTTGACTA
ACCGGAATTGA -> CCGGAATTGAA
ACCGTCATGAG -> CCGTCATGAGT
ACCGTCCTATA -> CCGTCCTATAA
ACCGTTAAGCC -> CCGTTAAGCCC
ACCTACGGGAG -> CCTACGGGAGT
ACCTACGTCTT -> CCTACGTCTTT
ACCTAGATGCT -> CCTAGATGCTC
ACCTATGTCCA -> CCTATGTCCAC
ACCTCGTGTTG -> CCTCGTGTTGT
ACCTCTCATGA -> CCTCTCATGAG
ACCTGCATCTC -> CCTGCATCTCC
ACCTGGTAGAT -> CCTGGTAGATC
ACCTTACCGGA -> CCTTACCGGAA
ACCTTACTGCC -> CCTTACTGCCT
ACCTTTCCACC -> CCTTTCCACCC
ACGACCTTACC -> CGACCTTACCG
ACGACTCTCCT -> CGACTCTCCTG
ACGAGCTAAAT -> CGAGCTAAATG
ACGATTCATGT -> CGATTCATGTT
ACGCACCTACG -> CGCACCTACGT
ACGCCGTACAC -> CGCCGTACACT
ACGCGCGGCTA -> CGCGCGGCTAG
ACGCTACGTTT -> CGCTACGTTTT
ACGCTATGGGG -> CGCTATGGGGG
ACGCTATTCTG -> CGCTATTCTGT
ACGGAGAGGGA -> CGGAGAGGGAC
ACGGATCCACA -> CGGATCCACAA
ACGGGAGTTAT -> CGGGAGTTATT
ACGGGAGTTCG -> CGGGAGTTCGC
ACGGGCCCCAC -> CGGGCCCCACG
ACGGGTAGGCT -> CGGGTAGGCTG
ACGGGTCATGG -> CGGGTCATGGG
ACGGTGGGTTA -> CGGTGGGTTAA
ACGTATCGAGC -> CGTATCGAGCC
ACGTCCAAGGC -> CGTCCAAGGCG
ACGTCGAAAGG -> CGTCGAAAGGT
ACGTCTTTAAG -> CGTCTTTAAGG
ACGTGAGCTGC -> CGTGAGCTGCA
ACGTGAGGTTC -> CGTGAGGTTCT
ACGTGAGTCTG -> CGTGAGTCTGG
ACGTGCGTCTG -> CGTGCGTCTGC
ACGTGTAAGCT -> CGTGTAAGCTT
ACGTTCTAGTC -> CGTTCTAGTCG
ACGTTTTACGT -> CGTTTTACGTG
ACTAATGCCCG -> CTAATGCCCGG
ACTACCGTCCT -> CTACCGTCCTA
ACTACGGGAGT -> CTACGGGAGTT
ACTAGAGCGCG -> CTAGAGCGCGT
ACTAGCTGTGG -> CTAGCTGTGGA
ACTATCTCTAG -> CTATCTCTAGA
ACTATTATCAA -> CTATTATCAAA
ACTCAAGCGTC -> CTCAAGCGTCC
ACTCACTTGCT -> CTCACTTGCTG
ACTCATCTGTC -> CTCATCTGTCC
ACTCCAAACTA -> CTCCAAACTAC
ACTCCGACGCG -> CTCCGACGCGC
ACTCCTAGCGG -> CTCCTAGCGGC
ACTCTCCTGAG -> CTCTCCTGAGG
ACTGCCTACTA -> CTGCCTACTAT
ACTGCGATATA -> CTGCGATATAT
ACTGTTAGGTC -> CTGTTAGGTCA
ACTTAAGCAAC -> CTTAAGCAACC
ACTTAGTCCAG -> CTTAGTCCAGG
ACTTGCATTGA -> CTTGCATTGAA
ACTTGCTGATC -> CTTGCTGATCC
ACTTTATTCTG -> CTTTATTCTGG
ACTTTGTTGCT -> CTTTGTTGCTA
AGAAAATAACT -> GAAAATAACTC
AGAACAAGGAT -> GAACAAGGATA
AGAACATGAAA -> GAACATGAAAG
AGAACCCCGAG -> GAACCCCGAGT
AGAACCGTTAA -> GAACCGTTAAG
AGAACGGGTAG -> GAACGGGTAGG
AGAACGGGTCA -> GAACGGGTCAT
AGAACTTGCAT -> GAACTTGCATT
AGAAGCTCATT -> GAAGCTCATTA
AGAAGTCGCAA -> GAAGTCGCAAT
AGAATCAGAAA -> GAATCAGAAAA
AGAATTGAGTG -> GAATTGAGTGG
AGACAACACTA -> GACAACACTAC
AGACCCAGCTA -> GACCCAGCTAA
AGACCGCTTGA -> GACCGCTTGAC
AGACCTACGGG -> GACCTACGGGA
AGACTTAAGCA -> GACTTAAGCAA
AGAGAACTTGC -> GAGAACTTGCA
AGAGATGAGGC -> GAGATGAGGCT
AGAGCGCGTGT -> GAGCGCGTGTG
AGAGGGACAAG -> GAGGGACAAGA
AGAGTTAGAAG -> GAGTTAGAAGC
AGAGTTGCTTC -> GAGTTGCTTCC
AGATCTAAGTA -> GATCTAAGTAA
AGATGAGGCTT -> GATGAGGCTTT
AGATGCTCGGT -> GATGCTCGGTT
AGATGTGGTGC -> GATGTGGTGCC
AGATTCGTAAG -> GATTCGTAAGC
AGATTCTCGAG -> GATTCTCGAGT
AGATTTAAGCC -> GATTTAAGCCA
AGCAACCTTTC -> GCAACCTTTCC
AGCAATGGGTA -> GCAATGGGTAG
AGCAATTAAGC -> GCAATTAAGCG
AGCACCTCGTG -> GCACCTCGTGT
AGCACGCTATT -> GCACGCTATTC
AGCACGTATCG -> GCACGTATCGA
AGCAGAGTTAG -> GCAGAGTTAGA
AGCAGCCGAGC -> GCAGCCGAGCA
AGCAGCCTAGG -> GCAGCCTAGGG
AGCATCACCCC -> GCATCACCCCC
AGCCAGAACGG -> GCCAGAACGGG
AGCCAGGAAGC -> GCCAGGAAGCG
AGCCATGAGAA -> GCCATGAGAAT
AGCCCGGGCTC -> GCCCGGGCTCT
AGCCCGTTAAT -> GCCCGTTAATA
AGCCCTAAGCC -> GCCCTAAGCCT
AGCCGAGCATC -> GCCGAGCATCA
AGCCTAGGGAG -> GCCTAGGGAGC
AGCCTAGGTGT -> GCCTAGGTGTA
AGCCTTGTAGA -> GCCTTGTAGAA
AGCGAAAAAGT -> GCGAAAAAGTG
AGCGACACCAT -> GCGACACCATT
AGCGACGGTGG -> GCGACGGTGGG
AGCGACTAGCT -> GCGACTAGCTG
AGCGAGGGACG -> GCGAGGGACGT
AGCGCGTGTGC -> GCGCGTGTGCA
AGCGGCAGCGG -> GCGGCAGCGGC
AGCGGCGGTTA -> GCGGCGGTTAA
AGCGGCTCTAC -> GCGGCTCTACC
AGCGGCTGTTC -> GCGGCTGTTCT
AGCGTCCGCGT -> GCGTCCGCGTC
AGCGTCGTTAC -> GCGTCGTTACG
AGCGTGACTTA -> GCGTGACTTAG
AGCTAAATGAA -> GCTAAATGAAA
AGCTAATTGTT -> GCTAATTGTTT
AGCTACTATCT -> GCTACTATCTC
AGCTATCGTTT -> GCTATCGTTTG
AGCTCAGCACG -> GCTCAGCACGT
AGCTCATTACC -> GCTCATTACCC
AGCTCGTCGTG -> GCTCGTCGTGC
AGCTGCAGGAA -> GCTGCAGGAAT
AGCTGTGGAAG -> GCTGTGGAAGT
AGCTTAATATG -> GCTTAATATGA
AGCTTCTAAGT -> GCTTCTAAGTT
AGGAAGCGAAA -> GGAAGCGAAAA
AGGAATAATTG -> GGAATAATTGG
AGGATAAATAA -> GGATAAATAAA
AGGATCGTCAC -> GGATCGTCACG
AGGCGACTAGA -> GGCGACTAGAG
AGGCGCAAGTA -> GGCGCAAGTAA
AGGCGCGTTTA -> GGCGCGTTTAA
AGGCGCTACAA -> GGCGCTACAAG
AGGCTCTCTGT -> GGCTCTCTGTT
AGGCTGTGCAT -> GGCTGTGCATT
AGGCTTTGCGC -> GGCTTTGCGCA
AGGGACAAGAA -> GGGACAAGAAC
AGGGACGTGAG -> GGGACGTGAGC
AGGGAGCAATG -> GGGAGCAATGG
AGGGCGCGGGG -> GGGCGCGGGGC
AGGGTCACTCA -> GGGTCACTCAA
AGGGTCCGACT -> GGGTCCGACTG
AGGTCAGGGTC -> GGTCAGGGTCA
AGGTCCACGTG -> GGTCCACGTGC
AGGTCTTCGAA -> GGTCTTCGAAG
AGGTGGGCTGG -> GGTGGGCTGGC
AGGTGTATGGT -> GGTGTATGGTG
AGGTGTGACGC -> GGTGTGACGCT
AGGTTAACCAT -> GGTTAACCATG
AGGTTAATATC -> GGTTAATATCT
AGGTTCTAGCG -> GGTTCTAGCGT
AGTAACACGGA -> GTAACACGGAG
AGTAACCCCGA -> GTAACCCCGAC
AGTAACTGCGA -> GTAACTGCGAT
AGTACGGATCC -> GTACGGATCCA
AGTAGCGTCGT -> GTAGCGTCGTT
AGTATCTTCAA -> GTATCTTCAAA
AGTCCAGGTTA -> GTCCAGGTTAA
AGTCCTAACCT -> GTCCTAACCTT
AGTCGCAATGT -> GTCGCAATGTG
AGTCGGAGCCC -> GTCGGAGCCCG
AGTCTGGCCCC -> GTCTGGCCCCC
AGTGAGTTGTT -> GTGAGTTGTTG
AGTGCCCGTTC -> GTGCCCGTTCA
AGTGGACCAGC -> GTGGACCAGCT
AGTGGACTCCA -> GTGGACTCCAA
AGTGGGACGTT -> GTGGGACGTTC
AGTGGGATGTG -> GTGGGATGTGT
AGTGGGCGCTC -> GTGGGCGCTCA
AGTGGGTGGGC -> GTGGGTGGGCG
AGTGGTCGTTA -> GTGGTCGTTAG
AGTGGTTGTGT -> GTGGTTGTGTG
AGTGTCGACAT -> GTGTCGACATC
AGTTACGCCGT -> GTTACGCCGTA
AGTTAGAAGCT -> GTTAGAAGCTC
AGTTATTATGT -> GTTATTATGTG
AGTTCAATGCT -> GTTCAATGCTG
AGTTCGCCAAA -> GTTCGCCAAAC
AGTTGCTTCCA -> GTTGCTTCCAG
AGTTGGAAAGT -> GTTGGAAAGTC
AGTTGTTGGAC -> GTTGTTGGACA
AGTTTGACATC -> GTTTGACATCC
AGTTTTGCCAA -> GTTTTGCCAAA
ATAAAAACCTG -> TAAAAACCTGC
ATAAACATCGT -> TAAACATCGTG
ATAAAGCAGCC -> TAAAGCAGCCT
ATAAAGCCAGA -> TAAAGCCAGAA
ATAAATAAAGC -> TAAATAAAGCA
ATAAATGCATC -> TAAATGCATCG
ATAACGTGAGG -> TAACGTGAGGT
ATAACTCACTT -> TAACTCACTTG
ATAAGCAGCCG -> TAAGCAGCCGA
ATAATAAATGC -> TAATAAATGCA
ATAATTGGTTA -> TAATTGGTTAT
ATAATTTGCGG -> TAATTTGCGGA
ATACAGACTTA -> TACAGACTTAA
ATAGAACATGA -> TAGAACATGAA
ATAGCCATGAG -> TAGCCATGAGA
ATAGTACGGAT -> TAGTACGGATC
ATATATCTCGC -> TATATCTCGCT
ATATCTCGCTG -> TATCTCGCTGG
ATATCTCTGAG -> TATCTCTGAGT
ATATGAACGAT -> TATGAACGATT
ATCAAAAATCC -> TCAAAAATCCC
ATCACCCCCGA -> TCACCCCCGAG
ATCAGAAAATA -> TCAGAAAATAA
ATCAGATTCTC -> TCAGATTCTCG
ATCATGACAAT -> TCATGACAATA
ATCCACAATTG -> TCCACAATTGA
ATCCCAAGACC -> TCCCAAGACCT
ATCCCACTCCG -> TCCCACTCCGA
ATCCTGAGTTA -> TCCTGAGTTAC
ATCCTGGGCTT -> TCCTGGGCTTA
ATCCTTCTAGG -> TCCTTCTAGGG
ATCGAGCCCTA -> TCGAGCCCTAA
ATCGATAATAA -> TCGATAATAAA
ATCGATGGGAC -> TCGATGGGACG
ATCGCGTGTTT -> TCGCGTGTTTT
ATCGGAGCCTA -> TCGGAGCCTAG
ATCGGAGTGGA -> TCGGAGTGGAC
ATCGGTAGCGA -> TCGGTAGCGAG
ATCGGTCAGCT -> TCGGTCAGCTA
ATCGTCACGAC -> TCGTCACGACT
ATCGTGTGTTG -> TCGTGTGTTGC
ATCGTTTGACC -> TCGTTTGACCC
ATCTAAGTAAC -> TCTAAGTAACC
ATCTCCGGTGG -> TCTCCGGTGGG
ATCTCGCTGGA -> TCTCGCTGGAC
ATCTCTAGAAC -> TCTCTAGAACG
ATCTCTGAGTT -> TCTCTGAGTTG
ATCTGTCCATT -> TCTGTCCATTC
ATCTTCAAAAC -> TCTTCAAAACC
ATGAAAATTCA -> TGAAAATTCAA
ATGAAAGCTTC -> TGAAAGCTTCT
ATGAACGATTC -> TGAACGATTCA
ATGACAATAGT -> TGACAATAGTA
ATGACATCGGA -> TGACATCGGAG
ATGAGAATCAG -> TGAGAATCAGA
ATGAGATTCGT -> TGAGATTCGTA
ATGAGCACCTC -> TGAGCACCTCG
ATGAGGCTTTG -> TGAGGCTTTGC
ATGAGTAGCGT -> TGAGTAGCGTC
ATGAGTATCTT -> TGAGTATCTTC
ATGATTAAGCA -> TGATTAAGCAG
ATGCATCGGTC -> TGCATCGGTCA
ATGCCCGGCCC -> TGCCCGGCCCG
ATGCCCTCATC -> TGCCCTCATCG
ATGCCGTCATT -> TGCCGTCATTT
ATGCTCCTGCT -> TGCTCCTGCTT
ATGCTCGGTTC -> TGCTCGGTTCA
ATGCTGATGTT -> TGCTGATGTTC
ATGGGACGGGC -> TGGGACGGGCC
ATGGGCCCAGC -> TGGGCCCAGCG
ATGGGCTAAAA -> TGGGCTAAAAC
ATGGGGGGGAC -> TGGGGGGGACA
ATGGGTAGCGA -> TGGGTAGCGAC
ATGGTGGGCGG -> TGGTGGGCGGA
ATGTCCACGTC -> TGTCCACGTCG
ATGTGAACCCG -> TGTGAACCCGA
ATGTGGGAGAC -> TGTGGGAGACC
ATGTGGGCTCA -> TGTGGGCTCAT
ATGTGGTGCCA -> TGTGGTGCCAG
ATGTGTAGACA -> TGTGTAGACAA
ATGTGTCACCT -> TGTGTCACCTC
ATGTTCACCGA -> TGTTCACCGAC
ATGTTCTTAAT -> TGTTCTTAATA
ATTAAGCAGAG -> TTAAGCAGAGT
ATTAAGCGACA -> TTAAGCGACAC
ATTACCCCACG -> TTACCCCACGT
ATTACGAGCTA -> TTACGAGCTAA
ATTATCAAAAA -> TTATCAAAAAT
ATTATGTGTCA -> TTATGTGTCAC
ATTCAAGAGAA -> TTCAAGAGAAC
ATTCATGTTCT -> TTCATGTTCTT
ATTCGTAAGCG -> TTCGTAAGCGG
ATTCTCGAGTG -> TTCTCGAGTGG
ATTCTGGCTGT -> TTCTGGCTGTC
ATTCTGTCCGC -> TTCTGTCCGCT
ATTCTTAAAAT -> TTCTTAAAATG
ATTGAAGCTCA -> TTGAAGCTCAG
ATTGAAGTGGA -> TTGAAGTGGAC
ATTGACTCCTA -> TTGACTCCTAG
ATTGAGTGGTT -> TTGAGTGGTTG
ATTGATAACGT -> TTGATAACGTG
ATTGCAAAAGT -> TTGCAAAAGTG
ATTGGTGTTGT -> TTGGTGTTGTG
ATTGGTTATTG -> TTGGTTATTGC
ATTGTTTATGC -> TTGTTTATGCT
ATTTAACAGAT -> TTTAACAGATG
ATTTAAGCCAG -> TTTAAGCCAGG
ATTTGCATCCT -> TTTGCATCCTG
ATTTGCGGATG -> TTTGCGGATGT
ATTTTGCTGCG -> TTTTGCTGCGT
CAAAAATCCCA -> AAAAATCCCAA
CAAAACCGTCA -> AAAACCGTCAT
CAAAAGTGGGA -> AAAAGTGGGAT
CAAACCTATGT -> AAACCTATGTC
CAAACTACCGT -> AAACTACCGTC
CAAATAAGCAG -> AAATAAGCAGC
CAAATGTGAAC -> AAATGTGAACC
CAACACTACGG -> AACACTACGGG
CAACCTTTCCA -> AACCTTTCCAC
CAACTCATCTG -> AACTCATCTGT
CAAGAACCCCG -> AAGAACCCCGA
CAAGACCTACG -> AAGACCTACGG
CAAGAGAACTT -> AAGAGAACTTG
CAAGCACGCTA -> AAGCACGCTAT
CAAGCGTCCGC -> AAGCGTCCGCG
CAAGGATAAAT -> AAGGATAAATA
CAAGGCGCGTT -> AAGGCGCGTTT
CAAGTAACACG -> AAGTAACACGG
CAAGTTTGACA -> AAGTTTGACAT
CAATAAACATC -> AATAAACATCG
CAATAGTACGG -> AATAGTACGGA
CAATGAGATTC -> AATGAGATTCG
CAATGCTGATG -> AATGCTGATGT
CAATGGGTAGC -> AATGGGTAGCG
CAATGTGGGAG -> AATGTGGGAGA
CAATTAAGCGA -> AATTAAGCGAC
CAATTGATAAC -> AATTGATAACG
CAATTTGCATC -> AATTTGCATCC
CACAATTGATA -> ACAATTGATAA
CACATCGATAA -> ACATCGATAAT
CACCATTACGA -> ACCATTACGAG
CACCCCCATCC -> ACCCCCATCCC
CACCCCCGAGC -> ACCCCCGAGCA
CACCGACAGGT -> ACCGACAGGTT
CACCGAGACCC -> ACCGAGACCCA
CACCGAGTTTT -> ACCGAGTTTTG
CACCTACGTCT -> ACCTACGTCTT
CACCTAGATGC -> ACCTAGATGCT
CACCTCGTGTT -> ACCTCGTGTTG
CACCTCTCATG -> ACCTCTCATGA
CACCTGGTAGA -> ACCTGGTAGAT
CACGACCTTAC -> ACGACCTTACC
CACGACTCTCC -> ACGACTCTCCT
CACGCTATGGG -> ACGCTATGGGG
CACGCTATTCT -> ACGCTATTCTG
CACGGAGAGGG -> ACGGAGAGGGA
CACGTATCGAG -> ACGTATCGAGC
CACGTCGAAAG -> ACGTCGAAAGG
CACGTGAGTCT -> ACGTGAGTCTG
CACGTGCGTCT -> ACGTGCGTCTG
CACTACGGGAG -> ACTACGGGAGT
CACTCAAGCGT -> ACTCAAGCGTC
CACTCCGACGC -> ACTCCGACGCG
CACTTGCTGAT -> ACTTGCTGATC
CACTTTATTCT -> ACTTTATTCTG
CAGAAAATAAC -> AGAAAATAACT
CAGAACGGGTA -> AGAACGGGTAG
CAGACTTAAGC -> AGACTTAAGCA
CAGAGTTAGAA -> AGAGTTAGAAG
CAGATGTGGTG -> AGATGTGGTGC
CAGATTCTCGA -> AGATTCTCGAG
CAGCACGTATC -> AGCACGTATCG
CAGCCGAGCAT -> AGCCGAGCATC
CAGCCTAGGGA -> AGCCTAGGGAG
CAGCGACTAGC -> AGCGACTAGCT
CAGCGGCAGCG -> AGCGGCAGCGG
CAGCGGCGGTT -> AGCGGCGGTTA
CAGCTAATTGT -> AGCTAATTGTT
CAGCTACTATC -> AGCTACTATCT
CAGCTATCGTT -> AGCTATCGTTT
CAGCTCGTCGT -> AGCTCGTCGTG
CAGGAAGCGAA -> AGGAAGCGAAA
CAGGAATAATT -> AGGAATAATTG
CAGGATCGTCA -> AGGATCGTCAC
CAGGCGACTAG -> AGGCGACTAGA
CAGGCGCTACA -> AGGCGCTACAA
CAGGGTCACTC -> AGGGTCACTCA
CAGGGTCCGAC -> AGGGTCCGACT
CAGGTTAACCA -> AGGTTAACCAT
CAGGTTAATAT -> AGGTTAATATC
CAGTGTCGACA -> AGTGTCGACAT
CATACAGACTT -> ATACAGACTTA
CATCACCCCCG -> ATCACCCCCGA
CATCCCACTCC -> ATCCCACTCCG
CATCCTGAGTT -> ATCCTGAGTTA
CATCCTTCTAG -> ATCCTTCTAGG
CATCGATAATA -> ATCGATAATAA
CATCGATGGGA -> ATCGATGGGAC
CATCGGAGCCT -> ATCGGAGCCTA
CATCGGAGTGG -> ATCGGAGTGGA
CATCGGTAGCG -> ATCGGTAGCGA
CATCGGTCAGC -> ATCGGTCAGCT
CATCGTGTGTT -> ATCGTGTGTTG
CATCTCCGGTG -> ATCTCCGGTGG
CATCTGTCCAT -> ATCTGTCCATT
CATGAAAGCTT -> ATGAAAGCTTC
CATGACAATAG -> ATGACAATAGT
CATGACATCGG -> ATGACATCGGA
CATGAGAATCA -> ATGAGAATCAG
CATGAGCACCT -> ATGAGCACCTC
CATGAGTAGCG -> ATGAGTAGCGT
CATGATTAAGC -> ATGATTAAGCA
CATGCCCTCAT -> ATGCCCTCATC
CATGGGCTAAA -> ATGGGCTAAAA
CATGTTCTTAA -> ATGTTCTTAAT
CATTACCCCAC -> ATTACCCCACG
CATTACGAGCT -> ATTACGAGCTA
CATTCTTAAAA -> ATTCTTAAAAT
CATTGAAGCTC -> ATTGAAGCTCA
CATTGACTCCT -> ATTGACTCCTA
CATTGGTGTTG -> ATTGGTGTTGT
CATTTAACAGA -> ATTTAACAGAT
CCAAACCTATG -> CAAACCTATGT
CCAAACTACCG -> CAAACTACCGT
CCAAATAAGCA -> CAAATAAGCAG
CCAACTCATCT -> CAACTCATCTG
CCAAGACCTAC -> CAAGACCTACG
CCAAGGCGCGT -> CAAGGCGCGTT
CCAATTTGCAT -> CAATTTGCATC
CCACAATTGAT -> CACAATTGATA
CCACCCCCATC -> CACCCCCATCC
CCACCTGGTAG -> CACCTGGTAGA
CCACGACCTTA -> CACGACCTTAC
CCACGCTATGG -> CACGCTATGGG
CCACGTCGAAA -> CACGTCGAAAG
CCACGTGAGTC -> CACGTGAGTCT
CCACGTGCGTC -> CACGTGCGTCT
CCACTCCGACG -> CACTCCGACGC
CCAGAACGGGT -> CAGAACGGGTA
CCAGCGACTAG -> CAGCGACTAGC
CCAGCTAATTG -> CAGCTAATTGT
CCAGCTATCGT -> CAGCTATCGTT
CCAGCTCGTCG -> CAGCTCGTCGT
CCAGGAAGCGA -> CAGGAAGCGAA
CCAGGCGACTA -> CAGGCGACTAG
CCAGGTTAACC -> CAGGTTAACCA
CCATACAGACT -> CATACAGACTT
CCATCCCACTC -> CATCCCACTCC
CCATCGGAGCC -> CATCGGAGCCT
CCATGAGAATC -> CATGAGAATCA
CCATGCCCTCA -> CATGCCCTCAT
CCATTACGAGC -> CATTACGAGCT
CCATTCTTAAA -> CATTCTTAAAA
CCCAAGACCTA -> CCAAGACCTAC
CCCACGACCTT -> CCACGACCTTA
CCCACGCTATG -> CCACGCTATGG
CCCACGTGAGT -> CCACGTGAGTC
CCCACTCCGAC -> CCACTCCGACG
CCCAGCGACTA -> CCAGCGACTAG
CCCAGCTAATT -> CCAGCTAATTG
CCCATACAGAC -> CCATACAGACT
CCCATCCCACT -> CCATCCCACTC
CCCCACGCTAT -> CCCACGCTATG
CCCCACGTGAG -> CCCACGTGAGT
CCCCATCCCAC -> CCCATCCCACT
CCCCCATCCCA -> CCCCATCCCAC
CCCCCGAGCAA -> CCCCGAGCAAT
CCCCCTCCTGT -> CCCCTCCTGTG
CCCCGACCCAT -> CCCGACCCATA
CCCCGAGCAAT -> CCCGAGCAATT
CCCCGAGTAAC -> CCCGAGTAACT
CCCCTCACCGA -> CCCTCACCGAG
CCCCTCCTGTG -> CCCTCCTGTGG
CCCGACCAATT -> CCGACCAATTT
CCCGACCCATA -> CCGACCCATAC
CCCGAGCAATT -> CCGAGCAATTA
CCCGAGTAACT -> CCGAGTAACTG
CCCGGCCCGTG -> CCGGCCCGTGC
CCCGGGCTCTG -> CCGGGCTCTGA
CCCGTGCCGTC -> CCGTGCCGTCA
CCCGTTAATAG -> CCGTTAATAGA
CCCGTTCAAGT -> CCGTTCAAGTT
CCCTAAGCCTT -> CCTAAGCCTTG
CCCTCACCGAG -> CCTCACCGAGA
CCCTCATCGAT -> CCTCATCGATG
CCCTCCTGTGG -> CCTCCTGTGGC
CCGACAGGTTA -> CGACAGGTTAA
CCGACCAATTT -> CGACCAATTTG
CCGACCCATAC -> CGACCCATACA
CCGACGCGCGG -> CGACGCGCGGC
CCGACTGTTAG -> CGACTGTTAGG
CCGAGACCCAG -> CGAGACCCAGC
CCGAGCAATTA -> CGAGCAATTAA
CCGAGCATCAC -> CGAGCATCACC
CCGAGTAACTG -> CGAGTAACTGC
CCGAGTTTTGC -> CGAGTTTTGCC
CCGCGTCGTGG -> CGCGTCGTGGC
CCGCTGGTAGT -> CGCTGGTAGTG
CCGCTTGACTA -> CGCTTGACTAA
CCGGAATTGAA -> CGGAATTGAAG
CCGGCCCGTGC -> CGGCCCGTGCC
CCGGGCTCTGA -> CGGGCTCTGAA
CCGGTGGGAAT -> CGGTGGGAATG
CCGTACACTTT -> CGTACACTTTA
CCGTCAATGAG -> CGTCAATGAGA
CCGTCATGAGT -> CGTCATGAGTA
CCGTCATTTAA -> CGTCATTTAAC
CCGTCCTATAA -> CGTCCTATAAT
CCGTGCCGTCA -> CGTGCCGTCAA
CCGTTAAGCCC -> CGTTAAGCCCG
CCGTTAATAGA -> CGTTAATAGAA
CCGTTCAAGTT -> CGTTCAAGTTT
CCTAACCTTAC -> CTAACCTTACT
CCTAAGCCTTG -> CTAAGCCTTGT
CCTACGGGAGT -> CTACGGGAGTT
CCTACGTCTTT -> CTACGTCTTTA
CCTACTATTAT -> CTACTATTATC
CCTAGATGCTC -> CTAGATGCTCG
CCTAGCGGCTC -> CTAGCGGCTCT
CCTAGGGAGCA -> CTAGGGAGCAA
CCTAGGTGTAT -> CTAGGTGTATG
CCTATAATTTG -> CTATAATTTGC
CCTATGTCCAC -> CTATGTCCACG
CCTCACCGAGA -> CTCACCGAGAC
CCTCATCGATG -> CTCATCGATGG
CCTCCTGTGGC -> CTCCTGTGGCT
CCTCGTGTTGT -> CTCGTGTTGTA
CCTCTCATGAG -> CTCTCATGAGC
CCTGAGGTGTG -> CTGAGGTGTGA
CCTGAGTTACG -> CTGAGTTACGC
CCTGCACCTAG -> CTGCACCTAGA
CCTGCATCTCC -> CTGCATCTCCG
CCTGCTTTTCT -> CTGCTTTTCTC
CCTGGGCTTAT -> CTGGGCTTATG
CCTGGTAGATC -> CTGGTAGATCT
CCTGTGGCTAT -> CTGTGGCTATT
CCTTACCGGAA -> CTTACCGGAAT
CCTTACTGCCT -> CTTACTGCCTA
CCTTCTAGGGC -> CTTCTAGGGCG
CCTTGTAGAAG -> CTTGTAGAAGT
CCTTTCCACCC -> CTTTCCACCCC
CGAAAAAGTGG -> GAAAAAGTGGT
CGAAAGAGATG -> GAAAGAGATGA
CGAAAGGTGGG -> GAAAGGTGGGC
CGAAGTGGGTG -> GAAGTGGGTGG
CGACACCATTA -> GACACCATTAC
CGACAGGTTAA -> GACAGGTTAAT
CGACATCGGTA -> GACATCGGTAG
CGACCAATTTG -> GACCAATTTGC
CGACCATCGGA -> GACCATCGGAG
CGACCCATACA -> GACCCATACAG
CGACCTTACCG -> GACCTTACCGG
CGACGCGCGGC -> GACGCGCGGCT
CGACGGTGGGT -> GACGGTGGGTT
CGACTAGAGCG -> GACTAGAGCGC
CGACTAGCTGT -> GACTAGCTGTG
CGACTCTCCTG -> GACTCTCCTGA
CGACTGTTAGG -> GACTGTTAGGT
CGAGACCCAGC -> GAGACCCAGCT
CGAGCAATTAA -> GAGCAATTAAG
CGAGCATCACC -> GAGCATCACCC
CGAGCCCTAAG -> GAGCCCTAAGC
CGAGCTAAATG -> GAGCTAAATGA
CGAGGGACGTG -> GAGGGACGTGA
CGAGTAACTGC -> GAGTAACTGCG
CGAGTGGGCGC -> GAGTGGGCGCT
CGAGTTTTGCC -> GAGTTTTGCCA
CGATAATAAAT -> GATAATAAATG
CGATATATCTC -> GATATATCTCG
CGATCAGATTC -> GATCAGATTCT
CGATGGGACGG -> GATGGGACGGG
CGATTCATGTT -> GATTCATGTTC
CGCAAGTAACA -> GCAAGTAACAC
CGCAATGTGGG -> GCAATGTGGGA
CGCACCTACGT -> GCACCTACGTC
CGCAGCGGCAG -> GCAGCGGCAGC
CGCCAAACCTA -> GCCAAACCTAT
CGCCGTACACT -> GCCGTACACTT
CGCGCGGCTAG -> GCGCGGCTAGA
CGCGGCTAGAA -> GCGGCTAGAAT
CGCGGGGCTGA -> GCGGGGCTGAT
CGCGTCGTGGC -> GCGTCGTGGCG
CGCGTGTGCAG -> GCGTGTGCAGG
CGCGTGTTTTT -> GCGTGTTTTTT
CGCGTTTAACG -> GCGTTTAACGC
CGCTACAAGCA -> GCTACAAGCAC
CGCTACGTTTT -> GCTACGTTTTA
CGCTATGGGGG -> GCTATGGGGGG
CGCTATTCTGT -> GCTATTCTGTC
CGCTCAGGATC -> GCTCAGGATCG
CGCTCCCACGA -> GCTCCCACGAC
CGCTGGACGGG -> GCTGGACGGGT
CGCTGGTAGTG -> GCTGGTAGTGG
CGCTTGACTAA -> GCTTGACTAAT
CGGAATTGAAG -> GGAATTGAAGT
CGGAGAGGGAC -> GGAGAGGGACA
CGGAGCCCGTT -> GGAGCCCGTTA
CGGAGCCTAGG -> GGAGCCTAGGT
CGGAGGTCCAC -> GGAGGTCCACG
CGGAGTGGACT -> GGAGTGGACTC
CGGATCCACAA -> GGATCCACAAT
CGGATGTGGGC -> GGATGTGGGCT
CGGCAGCGGCG -> GGCAGCGGCGG
CGGCCCGTGCC -> GGCCCGTGCCG
CGGCGGTTAAA -> GGCGGTTAAAG
CGGCTAGAATT -> GGCTAGAATTG
CGGCTCTACCA -> GGCTCTACCAC
CGGCTGTTCTG -> GGCTGTTCTGC
CGGGAGTTATT -> GGGAGTTATTA
CGGGAGTTCGC -> GGGAGTTCGCC
CGGGCCCCACG -> GGGCCCCACGC
CGGGCTCTGAA -> GGGCTCTGAAC
CGGGGCTGATC -> GGGGCTGATCA
CGGGTAGGCTG -> GGGTAGGCTGT
CGGGTCATGGG -> GGGTCATGGGC
CGGTAGCGAGG -> GGTAGCGAGGG
CGGTCAGCTAC -> GGTCAGCTACT
CGGTGGGAATG -> GGTGGGAATGC
CGGTGGGTTAA -> GGTGGGTTAAT
CGGTTAAAGAT -> GGTTAAAGATT
CGGTTCAATAA -> GGTTCAATAAA
CGTAAGCGGCT -> GTAAGCGGCTG
CGTACACTTTA -> GTACACTTTAT
CGTATCGAGCC -> GTATCGAGCCC
CGTCAATGAGA -> GTCAATGAGAT
CGTCACGACTC -> GTCACGACTCT
CGTCATGAGTA -> GTCATGAGTAG
CGTCATTTAAC -> GTCATTTAACA
CGTCCAAGGCG -> GTCCAAGGCGC
CGTCCGCGTCG -> GTCCGCGTCGT
CGTCCTATAAT -> GTCCTATAATT
CGTCGAAAGGT -> GTCGAAAGGTG
CGTCGCTCCCA -> GTCGCTCCCAC
CGTCGTGCCTG -> GTCGTGCCTGC
CGTCGTGGCGA -> GTCGTGGCGAA
CGTCGTTACGT -> GTCGTTACGTC
CGTCTAGAACA -> GTCTAGAACAA
CGTCTGCTTGT -> GTCTGCTTGTC
CGTCTTTAAGG -> GTCTTTAAGGC
CGTGACTTAGT -> GTGACTTAGTC
CGTGAGCTGCA -> GTGAGCTGCAG
CGTGAGGTTCT -> GTGAGGTTCTA
CGTGAGTCTGG -> GTGAGTCTGGC
CGTGCCGTCAA -> GTGCCGTCAAT
CGTGCCTGCAC -> GTGCCTGCACC
CGTGCGTCTGC -> GTGCGTCTGCT
CGTGGCGAAAG -> GTGGCGAAAGA
CGTGTAAGCTT -> GTGTAAGCTTA
CGTGTGCAGGC -> GTGTGCAGGCG
CGTGTGTTGCA -> GTGTGTTGCAC
CGTGTTGTAAG -> GTGTTGTAAGA
CGTGTTTTTTC -> GTGTTTTTTCG
CGTTAAGCCCG -> GTTAAGCCCGG
CGTTAATAGAA -> GTTAATAGAAC
CGTTACGTCCA -> GTTACGTCCAA
CGTTAGTGAGT -> GTTAGTGAGTT
CGTTCAAGTTT -> GTTCAAGTTTG
CGTTCTAGTCG -> GTTCTAGTCGG
CGTTGGTTGTA -> GTTGGTTGTAA
CGTTTAACGCA -> GTTTAACGCAC
CGTTTGACCCC -> GTTTGACCCCT
CGTTTTACGTG -> GTTTTACGTGT
CTAAAACTTTG -> TAAAACTTTGT
CTAAATGAAAA -> TAAATGAAAAT
CTAACCTTACT -> TAACCTTACTG
CTAAGCCTTGT -> TAAGCCTTGTA
CTAAGTAACCC -> TAAGTAACCCC
CTAAGTTCAAT -> TAAGTTCAATG
CTAATGCCCGG -> TAATGCCCGGC
CTAATTGTTTA -> TAATTGTTTAT
CTACAAGCACG -> TACAAGCACGC
CTACCACCTGG -> TACCACCTGGT
CTACCGTCCTA -> TACCGTCCTAT
CTACGGGAGTT -> TACGGGAGTTA,TACGGGAGTTC
CTACGTCTTTA -> TACGTCTTTAA
CTACGTTTTAC -> TACGTTTTACG
CTACTATCTCT -> TACTATCTCTA
CTACTATTATC -> TACTATTATCA
CTAGAACAAGG -> TAGAACAAGGA
CTAGAACGGGT -> TAGAACGGGTC
CTAGAATTGAG -> TAGAATTGAGT
CTAGAGCGCGT -> TAGAGCGCGTG
CTAGATGCTCG -> TAGATGCTCGG
CTAGCGGCTCT -> TAGCGGCTCTA
CTAGCGTGACT -> TAGCGTGACTT
CTAGCTGTGGA -> TAGCTGTGGAA
CTAGGCTCTCT -> TAGGCTCTCTG
CTAGGGAGCAA -> TAGGGAGCAAT
CTAGGGCGCGG -> TAGGGCGCGGG
CTAGGTCTTCG -> TAGGTCTTCGA
CTAGGTGTATG -> TAGGTGTATGG
CTAGTCGGAGC -> TAGTCGGAGCC
CTATAATTTGC -> TATAATTTGCG
CTATCGTTTGA -> TATCGTTTGAC
CTATCTCTAGA -> TATCTCTAGAA
CTATGGGGGGG -> TATGGGGGGGA
CTATGTCCACG -> TATGTCCACGT
CTATTATCAAA -> TATTATCAAAA
CTATTCTGTCC -> TATTCTGTCCG
CTATTTTGCTG -> TATTTTGCTGC
CTCAAGCGTCC -> TCAAGCGTCCG
CTCACCGAGAC -> TCACCGAGACC
CTCACTTGCTG -> TCACTTGCTGA
CTCAGCACGTA -> TCAGCACGTAT
CTCAGGATCGT -> TCAGGATCGTC
CTCATCGATGG -> TCATCGATGGG
CTCATCTGTCC -> TCATCTGTCCA
CTCATGAGCAC -> TCATGAGCACC
CTCATGATTAA -> TCATGATTAAG
CTCATTACCCC -> TCATTACCCCA
CTCCAAACTAC -> TCCAAACTACC
CTCCCACGACC -> TCCCACGACCT
CTCCGACGCGC -> TCCGACGCGCG
CTCCGGTGGGA -> TCCGGTGGGAA
CTCCTAGCGGC -> TCCTAGCGGCT
CTCCTGAGGTG -> TCCTGAGGTGT
CTCCTGCTTTT -> TCCTGCTTTTC
CTCCTGTGGCT -> TCCTGTGGCTA
CTCGAGTGGGC -> TCGAGTGGGCG
CTCGCTGGACG -> TCGCTGGACGG
CTCGGTTCAAT -> TCGGTTCAATA
CTCGTCGTGCC -> TCGTCGTGCCT
CTCGTGTTGTA -> TCGTGTTGTAA
CTCTACCACCT -> TCTACCACCTG
CTCTAGAACGG -> TCTAGAACGGG
CTCTAGGCTCT -> TCTAGGCTCTC
CTCTCATGAGC -> TCTCATGAGCA
CTCTCCTGAGG -> TCTCCTGAGGT
CTCTCTGTTTA -> TCTCTGTTTAT
CTCTGAACCAA -> TCTGAACCAAC
CTCTGAGTTGG -> TCTGAGTTGGA
CTCTGTTTATA -> TCTGTTTATAA
CTGAACCAACT -> TGAACCAACTC
CTGAGGTGTGA -> TGAGGTGTGAC
CTGAGTTACGC -> TGAGTTACGCC
CTGAGTTGGAA -> TGAGTTGGAAA
CTGATCATGAC -> TGATCATGACA
CTGATCCTGGG -> TGATCCTGGGC
CTGATGTTCAC -> TGATGTTCACC
CTGCACCTAGA -> TGCACCTAGAT
CTGCAGGAATA -> TGCAGGAATAA
CTGCATCTCCG -> TGCATCTCCGG
CTGCCTACTAT -> TGCCTACTATT
CTGCGATATAT -> TGCGATATATC
CTGCGTCGCTC -> TGCGTCGCTCC
CTGCGTTGGTT -> TGCGTTGGTTG
CTGCTTGTCAC -> TGCTTGTCACC
CTGCTTTTCTC -> TGCTTTTCTCT
CTGGCCCCCTC -> TGGCCCCCTCC
CTGGCTGTCAG -> TGGCTGTCAGG
CTGGCTTAGAA -> TGGCTTAGAAC
CTGGGCTTATG -> TGGGCTTATGG
CTGGTAGATCT -> TGGTAGATCTA
CTGGTAGTGGG -> TGGTAGTGGGA
CTGTCAGGGTC -> TGTCAGGGTCC
CTGTCCATTCT -> TGTCCATTCTT
CTGTCCGCTGG -> TGTCCGCTGGT
CTGTGCATTGG -> TGTGCATTGGT
CTGTGGAAGTG -> TGTGGAAGTGC
CTGTGGCTATT -> TGTGGCTATTT
CTGTTAGGTCA -> TGTTAGGTCAG
CTGTTCTGCGT -> TGTTCTGCGTC
CTGTTTATAAA -> TGTTTATAAAG
CTTAAAATGAG -> TTAAAATGAGT
CTTAAGCAACC -> TTAAGCAACCT
CTTAATAAAAA -> TTAATAAAAAC
CTTAATATGAA -> TTAATATGAAC
CTTACCGGAAT -> TTACCGGAATT
CTTACTGCCTA -> TTACTGCCTAC
CTTAGAACCGT -> TTAGAACCGTT
CTTAGTCCAGG -> TTAGTCCAGGT
CTTATGGGCCC -> TTATGGGCCCA
CTTCAAAACCG -> TTCAAAACCGT
CTTCCAGCTCG -> TTCCAGCTCGT
CTTCGAAGTGG -> TTCGAAGTGGG
CTTCTAAGTTC -> TTCTAAGTTCA
CTTCTAGGGCG -> TTCTAGGGCGC
CTTGACTAATG -> TTGACTAATGC
CTTGCATTGAA -> TTGCATTGAAG
CTTGCTGATCC -> TTGCTGATCCT
CTTGTAGAAGT -> TTGTAGAAGTC
CTTGTCACCGA -> TTGTCACCGAG
CTTTAAGGCGC -> TTTAAGGCGCA
CTTTATTCTGG -> TTTATTCTGGC
CTTTCCACCCC -> TTTCCACCCCC
CTTTGCGCAGC -> TTTGCGCAGCG
CTTTGTTGCTA -> TTTGTTGCTAG
CTTTTCTCTAG -> TTTTCTCTAGG
GAAAAAGTGGT -> AAAAAGTGGTC
GAAAATAACTC -> AAAATAACTCA
GAAAATTCAAG -> AAAATTCAAGA
GAAAGAGATGA -> AAAGAGATGAG
GAAAGCTTCTA -> AAAGCTTCTAA
GAAAGGTGGGC -> AAAGGTGGGCT
GAAAGTCCTAA -> AAAGTCCTAAC
GAACAAGGATA -> AACAAGGATAA
GAACATGAAAG -> AACATGAAAGC
GAACCAACTCA -> AACCAACTCAT
GAACCCCGAGT -> AACCCCGAGTA
GAACCCGACCA -> AACCCGACCAA
GAACCGTTAAG -> AACCGTTAAGC
GAACGATTCAT -> AACGATTCATG
GAACGGGTAGG -> AACGGGTAGGC
GAACGGGTCAT -> AACGGGTCATG
GAACTTGCATT -> AACTTGCATTG
GAAGCGAAAAA -> AAGCGAAAAAG
GAAGCTCAGCA -> AAGCTCAGCAC
GAAGCTCATTA -> AAGCTCATTAC
GAAGTCGCAAT -> AAGTCGCAATG
GAAGTGCCCGT -> AAGTGCCCGTT
GAAGTGGACCA -> AAGTGGACCAG
GAAGTGGGTGG -> AAGTGGGTGGG
GAATAATTGGT -> AATAATTGGTT
GAATCAGAAAA -> AATCAGAAAAT
GAATGCCGTCA -> AATGCCGTCAT
GAATTGAAGTG -> AATTGAAGTGG
GAATTGAGTGG -> AATTGAGTGGT
GACAACACTAC -> ACAACACTACG
GACAAGAACCC -> ACAAGAACCCC
GACAATAGTAC -> ACAATAGTACG
GACACCATTAC -> ACACCATTACG
GACAGGTTAAT -> ACAGGTTAATA
GACAGTGTCGA -> ACAGTGTCGAC
GACATCCTTCT -> ACATCCTTCTA
GACATCGGAGT -> ACATCGGAGTG
GACATCGGTAG -> ACATCGGTAGC
GACATTGACTC -> ACATTGACTCC
GACCAATTTGC -> ACCAATTTGCA
GACCAGCTATC -> ACCAGCTATCG
GACCATCGGAG -> ACCATCGGAGC
GACCCAGCTAA -> ACCCAGCTAAT
GACCCATACAG -> ACCCATACAGA
GACCCCTCACC -> ACCCCTCACCG
GACCGCTTGAC -> ACCGCTTGACT
GACCTACGGGA -> ACCTACGGGAG
GACCTTACCGG -> ACCTTACCGGA
GACGCGCGGCT -> ACGCGCGGCTA
GACGCTACGTT -> ACGCTACGTTT
GACGGGCCCCA -> ACGGGCCCCAC
GACGGTGGGTT -> ACGGTGGGTTA
GACGTGAGCTG -> ACGTGAGCTGC
GACGTTCTAGT -> ACGTTCTAGTC
GACTAATGCCC -> ACTAATGCCCG
GACTAGAGCGC -> ACTAGAGCGCG
GACTAGCTGTG -> ACTAGCTGTGG
GACTCCAAACT -> ACTCCAAACTA
GACTCCTAGCG -> ACTCCTAGCGG
GACTCTCCTGA -> ACTCTCCTGAG
GACTGTTAGGT -> ACTGTTAGGTC
GACTTAAGCAA -> ACTTAAGCAAC
GACTTAGTCCA -> ACTTAGTCCAG
GAGAACTTGCA -> AGAACTTGCAT
GAGAATCAGAA -> AGAATCAGAAA
GAGACCCAGCT -> AGACCCAGCTA
GAGACCGCTTG -> AGACCGCTTGA
GAGAGGGACAA -> AGAGGGACAAG
GAGATGAGGCT -> AGATGAGGCTT
GAGATTCGTAA -> AGATTCGTAAG
GAGCAATGGGT -> AGCAATGGGTA
GAGCAATTAAG -> AGCAATTAAGC
GAGCACCTCGT -> AGCACCTCGTG
GAGCATCACCC -> AGCATCACCCC
GAGCCCGTTAA -> AGCCCGTTAAT
GAGCCCTAAGC -> AGCCCTAAGCC
GAGCCTAGGTG -> AGCCTAGGTGT
GAGCGCGTGTG -> AGCGCGTGTGC
GAGCTAAATGA -> AGCTAAATGAA
GAGCTGCAGGA -> AGCTGCAGGAA
GAGGCTTTGCG -> AGGCTTTGCGC
GAGGGACAAGA -> AGGGACAAGAA
GAGGGACGTGA -> AGGGACGTGAG
GAGGTCCACGT -> AGGTCCACGTG
GAGGTGTGACG -> AGGTGTGACGC
GAGGTTCTAGC -> AGGTTCTAGCG
GAGTAACTGCG -> AGTAACTGCGA
GAGTAGCGTCG -> AGTAGCGTCGT
GAGTATCTTCA -> AGTATCTTCAA
GAGTCTGGCCC -> AGTCTGGCCCC
GAGTGGACTCC -> AGTGGACTCCA
GAGTGGGCGCT -> AGTGGGCGCTC
GAGTGGTTGTG -> AGTGGTTGTGT
GAGTTACGCCG -> AGTTACGCCGT
GAGTTAGAAGC -> AGTTAGAAGCT
GAGTTATTATG -> AGTTATTATGT
GAGTTCGCCAA -> AGTTCGCCAAA
GAGTTGCTTCC -> AGTTGCTTCCA
GAGTTGGAAAG -> AGTTGGAAAGT
GAGTTGTTGGA -> AGTTGTTGGAC
GAGTTTTGCCA -> AGTTTTGCCAA
GATAAATAAAG -> ATAAATAAAGC
GATAACGTGAG -> ATAACGTGAGG
GATAATAAATG -> ATAATAAATGC
GATATATCTCG -> ATATATCTCGC
GATCAGATTCT -> ATCAGATTCTC
GATCATGACAA -> ATCATGACAAT
GATCCACAATT -> ATCCACAATTG
GATCCTGGGCT -> ATCCTGGGCTT
GATCGTCACGA -> ATCGTCACGAC
GATCTAAGTAA -> ATCTAAGTAAC
GATGAGGCTTT -> ATGAGGCTTTG
GATGCTCGGTT -> ATGCTCGGTTC
GATGGGACGGG -> ATGGGACGGGC
GATGTGGGCTC -> ATGTGGGCTCA
GATGTGGTGCC -> ATGTGGTGCCA
GATGTGTAGAC -> ATGTGTAGACA
GATGTTCACCG -> ATGTTCACCGA
GATTAAGCAGA -> ATTAAGCAGAG
GATTCATGTTC -> ATTCATGTTCT
GATTCGTAAGC -> ATTCGTAAGCG
GATTCTCGAGT -> ATTCTCGAGTG
GATTTAAGCCA -> ATTTAAGCCAG
GCAAAAGTGGG -> CAAAAGTGGGA
GCAAATGTGAA -> CAAATGTGAAC
GCAACCTTTCC -> CAACCTTTCCA
GCAAGTAACAC -> CAAGTAACACG
GCAATGGGTAG -> CAATGGGTAGC
GCAATGTGGGA -> CAATGTGGGAG
GCAATTAAGCG -> CAATTAAGCGA
GCACATCGATA -> CACATCGATAA
GCACCTACGTC -> CACCTACGTCT
GCACCTAGATG -> CACCTAGATGC
GCACCTCGTGT -> CACCTCGTGTT
GCACGCTATTC -> CACGCTATTCT
GCACGTATCGA -> CACGTATCGAG
GCAGAGTTAGA -> CAGAGTTAGAA
GCAGCCGAGCA -> CAGCCGAGCAT
GCAGCCTAGGG -> CAGCCTAGGGA
GCAGCGGCAGC -> CAGCGGCAGCG
GCAGCGGCGGT -> CAGCGGCGGTT
GCAGGAATAAT -> CAGGAATAATT
GCAGGCGCTAC -> CAGGCGCTACA
GCATCACCCCC -> CATCACCCCCG
GCATCCTGAGT -> CATCCTGAGTT
GCATCGGTCAG -> CATCGGTCAGC
GCATCTCCGGT -> CATCTCCGGTG
GCATGACATCG -> CATGACATCGG
GCATTGAAGCT -> CATTGAAGCTC
GCATTGGTGTT -> CATTGGTGTTG
GCCAAACCTAT -> CCAAACCTATG
GCCAAATAAGC -> CCAAATAAGCA
GCCAGAACGGG -> CCAGAACGGGT
GCCAGGAAGCG -> CCAGGAAGCGA
GCCAGGCGACT -> CCAGGCGACTA
GCCATGAGAAT -> CCATGAGAATC
GCCCAGCGACT -> CCCAGCGACTA
GCCCCACGCTA -> CCCCACGCTAT
GCCCCCTCCTG -> CCCCCTCCTGT
GCCCGGCCCGT -> CCCGGCCCGTG
GCCCGGGCTCT -> CCCGGGCTCTG
GCCCGTGCCGT -> CCCGTGCCGTC
GCCCGTTAATA -> CCCGTTAATAG
GCCCGTTCAAG -> CCCGTTCAAGT
GCCCTAAGCCT -> CCCTAAGCCTT
GCCCTCATCGA -> CCCTCATCGAT
GCCGAGCATCA -> CCGAGCATCAC
GCCGTACACTT -> CCGTACACTTT
GCCGTCAATGA -> CCGTCAATGAG
GCCGTCATTTA -> CCGTCATTTAA
GCCTACTATTA -> CCTACTATTAT
GCCTAGGGAGC -> CCTAGGGAGCA
GCCTAGGTGTA -> CCTAGGTGTAT
GCCTGCACCTA -> CCTGCACCTAG
GCCTTGTAGAA -> CCTTGTAGAAG
GCGAAAAAGTG -> CGAAAAAGTGG
GCGAAAGAGAT -> CGAAAGAGATG
GCGACACCATT -> CGACACCATTA
GCGACGGTGGG -> CGACGGTGGGT
GCGACTAGAGC -> CGACTAGAGCG
GCGACTAGCTG -> CGACTAGCTGT
GCGAGGGACGT -> CGAGGGACGTG
GCGATATATCT -> CGATATATCTC
GCGATCAGATT -> CGATCAGATTC
GCGCAAGTAAC -> CGCAAGTAACA
GCGCAGCGGCA -> CGCAGCGGCAG
GCGCGGCTAGA -> CGCGGCTAGAA
GCGCGGGGCTG -> CGCGGGGCTGA
GCGCGTGTGCA -> CGCGTGTGCAG
GCGCGTTTAAC -> CGCGTTTAACG
GCGCTACAAGC -> CGCTACAAGCA
GCGCTCAGGAT -> CGCTCAGGATC
GCGGAGGTCCA -> CGGAGGTCCAC
GCGGATGTGGG -> CGGATGTGGGC
GCGGCAGCGGC -> CGGCAGCGGCG
GCGGCGGTTAA -> CGGCGGTTAAA
GCGGCTAGAAT -> CGGCTAGAATT
GCGGCTCTACC -> CGGCTCTACCA
GCGGCTGTTCT -> CGGCTGTTCTG
GCGGGGCTGAT -> CGGGGCTGATC
GCGGTTAAAGA -> CGGTTAAAGAT
GCGTCCGCGTC -> CGTCCGCGTCG
GCGTCGCTCCC -> CGTCGCTCCCA
GCGTCGTGGCG -> CGTCGTGGCGA
GCGTCGTTACG -> CGTCGTTACGT
GCGTCTAGAAC -> CGTCTAGAACA
GCGTCTGCTTG -> CGTCTGCTTGT
GCGTGACTTAG -> CGTGACTTAGT
GCGTGTGCAGG -> CGTGTGCAGGC
GCGTGTTTTTT -> CGTGTTTTTTC
GCGTTGGTTGT -> CGTTGGTTGTA
GCGTTTAACGC -> CGTTTAACGCA
GCTAAAACTTT -> CTAAAACTTTG
GCTAAATGAAA -> CTAAATGAAAA
GCTAATTGTTT -> CTAATTGTTTA
GCTACAAGCAC -> CTACAAGCACG
GCTACGTTTTA -> CTACGTTTTAC
GCTACTATCTC -> CTACTATCTCT
GCTAGAATTGA -> CTAGAATTGAG
GCTAGGTCTTC -> CTAGGTCTTCG
GCTATCGTTTG -> CTATCGTTTGA
GCTATGGGGGG -> CTATGGGGGGG
GCTATTCTGTC -> CTATTCTGTCC
GCTATTTTGCT -> CTATTTTGCTG
GCTCAGCACGT -> CTCAGCACGTA
GCTCAGGATCG -> CTCAGGATCGT
GCTCATGATTA -> CTCATGATTAA
GCTCATTACCC -> CTCATTACCCC
GCTCCCACGAC -> CTCCCACGACC
GCTCCTGCTTT -> CTCCTGCTTTT
GCTCGGTTCAA -> CTCGGTTCAAT
GCTCGTCGTGC -> CTCGTCGTGCC
GCTCTACCACC -> CTCTACCACCT
GCTCTCTGTTT -> CTCTCTGTTTA
GCTCTGAACCA -> CTCTGAACCAA
GCTGATCATGA -> CTGATCATGAC
GCTGATCCTGG -> CTGATCCTGGG
GCTGATGTTCA -> CTGATGTTCAC
GCTGCAGGAAT -> CTGCAGGAATA
GCTGCGTTGGT -> CTGCGTTGGTT
GCTGGCTTAGA -> CTGGCTTAGAA
GCTGGTAGTGG -> CTGGTAGTGGG
GCTGTCAGGGT -> CTGTCAGGGTC
GCTGTGCATTG -> CTGTGCATTGG
GCTGTGGAAGT -> CTGTGGAAGTG
GCTGTTCTGCG -> CTGTTCTGCGT
GCTTAATATGA -> CTTAATATGAA
GCTTAGAACCG -> CTTAGAACCGT
GCTTATGGGCC -> CTTATGGGCCC
GCTTCCAGCTC -> CTTCCAGCTCG
GCTTCTAAGTT -> CTTCTAAGTTC
GCTTGACTAAT -> CTTGACTAATG
GCTTGTCACCG -> CTTGTCACCGA
GCTTTGCGCAG -> CTTTGCGCAGC
GCTTTTCTCTA -> CTTTTCTCTAG
GGAAAGTCCTA -> GAAAGTCCTAA
GGAAGCGAAAA -> GAAGCGAAAAA
GGAAGTGCCCG -> GAAGTGCCCGT
GGAATAATTGG -> GAATAATTGGT
GGAATGCCGTC -> GAATGCCGTCA
GGAATTGAAGT -> GAATTGAAGTG
GGACAAGAACC -> GACAAGAACCC
GGACAGTGTCG -> GACAGTGTCGA
GGACATTGACT -> GACATTGACTC
GGACCAGCTAT -> GACCAGCTATC
GGACGGGCCCC -> GACGGGCCCCA
GGACGTGAGCT -> GACGTGAGCTG
GGACGTTCTAG -> GACGTTCTAGT
GGACTCCAAAC -> GACTCCAAACT
GGAGACCGCTT -> GAGACCGCTTG
GGAGAGGGACA -> GAGAGGGACAA
GGAGCAATGGG -> GAGCAATGGGT
GGAGCCCGTTA -> GAGCCCGTTAA
GGAGCCTAGGT -> GAGCCTAGGTG
GGAGGTCCACG -> GAGGTCCACGT
GGAGTGGACTC -> GAGTGGACTCC
GGAGTTATTAT -> GAGTTATTATG
GGAGTTCGCCA -> GAGTTCGCCAA
GGATAAATAAA -> GATAAATAAAG
GGATCCACAAT -> GATCCACAATT
GGATCGTCACG -> GATCGTCACGA
GGATGTGGGCT -> GATGTGGGCTC
GGATGTGTAGA -> GATGTGTAGAC
GGCAGCGGCGG -> GCAGCGGCGGT
GGCCCAGCGAC -> GCCCAGCGACT
GGCCCCACGCT -> GCCCCACGCTA
GGCCCCCTCCT -> GCCCCCTCCTG
GGCCCGTGCCG -> GCCCGTGCCGT
GGCGAAAGAGA -> GCGAAAGAGAT
GGCGACTAGAG -> GCGACTAGAGC
GGCGATCAGAT -> GCGATCAGATT
GGCGCAAGTAA -> GCGCAAGTAAC
GGCGCGGGGCT -> GCGCGGGGCTG
GGCGCGTTTAA -> GCGCGTTTAAC
GGCGCTACAAG -> GCGCTACAAGC
GGCGCTCAGGA -> GCGCTCAGGAT
GGCGGAGGTCC -> GCGGAGGTCCA
GGCGGTTAAAG -> GCGGTTAAAGA
GGCGTCTAGAA -> GCGTCTAGAAC
GGCTAAAACTT -> GCTAAAACTTT
GGCTAGAATTG -> GCTAGAATTGA
GGCTATTTTGC -> GCTATTTTGCT
GGCTCATGATT -> GCTCATGATTA
GGCTCTACCAC -> GCTCTACCACC
GGCTCTCTGTT -> GCTCTCTGTTT
GGCTCTGAACC -> GCTCTGAACCA
GGCTGATCATG -> GCTGATCATGA
GGCTGGCTTAG -> GCTGGCTTAGA
GGCTGTCAGGG -> GCTGTCAGGGT
GGCTGTGCATT -> GCTGTGCATTG
GGCTGTTCTGC -> GCTGTTCTGCG
GGCTTAGAACC -> GCTTAGAACCG
GGCTTATGGGC -> GCTTATGGGCC
GGCTTTGCGCA -> GCTTTGCGCAG
GGGAATGCCGT -> GGAATGCCGTC
GGGACAAGAAC -> GGACAAGAACC
GGGACAGTGTC -> GGACAGTGTCG
GGGACGGGCCC -> GGACGGGCCCC
GGGACGTGAGC -> GGACGTGAGCT
GGGACGTTCTA -> GGACGTTCTAG
GGGAGACCGCT -> GGAGACCGCTT
GGGAGCAATGG -> GGAGCAATGGG
GGGAGTTATTA -> GGAGTTATTAT
GGGAGTTCGCC -> GGAGTTCGCCA
GGGATGTGTAG -> GGATGTGTAGA
GGGCCCAGCGA -> GGCCCAGCGAC
GGGCCCCACGC -> GGCCCCACGCT
GGGCGCGGGGC -> GGCGCGGGGCT
GGGCGCTCAGG -> GGCGCTCAGGA
GGGCGGAGGTC -> GGCGGAGGTCC
GGGCGTCTAGA -> GGCGTCTAGAA
GGGCTAAAACT -> GGCTAAAACTT
GGGCTCATGAT -> GGCTCATGATT
GGGCTCTGAAC -> GGCTCTGAACC
GGGCTGATCAT -> GGCTGATCATG
GGGCTGGCTTA -> GGCTGGCTTAG
GGGCTTATGGG -> GGCTTATGGGC
GGGGACAGTGT -> GGGACAGTGTC
GGGGCTGATCA -> GGGCTGATCAT
GGGGGACAGTG -> GGGGACAGTGT
GGGGGGACAGT -> GGGGGACAGTG
GGGGGGGACAG -> GGGGGGACAGT
GGGTAGCGACG -> GGTAGCGACGG
GGGTAGGCTGT -> GGTAGGCTGTG
GGGTCACTCAA -> GGTCACTCAAG
GGGTCATGGGC -> GGTCATGGGCT
GGGTCCGACTG -> GGTCCGACTGT
GGGTGGGCGTC -> GGTGGGCGTCT
GGGTTAATCGC -> GGTTAATCGCG
GGTAGATCTAA -> GTAGATCTAAG
GGTAGCGACGG -> GTAGCGACGGT
GGTAGCGAGGG -> GTAGCGAGGGA
GGTAGGCTGTG -> GTAGGCTGTGC
GGTAGTGGGAC -> GTAGTGGGACG
GGTCACTCAAG -> GTCACTCAAGC
GGTCAGCTACT -> GTCAGCTACTA
GGTCAGGGTCA -> GTCAGGGTCAC
GGTCATGGGCT -> GTCATGGGCTA
GGTCCACGTGC -> GTCCACGTGCG
GGTCCGACTGT -> GTCCGACTGTT
GGTCGTTAGTG -> GTCGTTAGTGA
GGTCTTCGAAG -> GTCTTCGAAGT
GGTGCCAGGCG -> GTGCCAGGCGA
GGTGGGAATGC -> GTGGGAATGCC
GGTGGGCGGAG -> GTGGGCGGAGG
GGTGGGCGTCT -> GTGGGCGTCTA
GGTGGGCTGGC -> GTGGGCTGGCT
GGTGGGTTAAT -> GTGGGTTAATC
GGTGTATGGTG -> GTGTATGGTGG
GGTGTGACGCT -> GTGTGACGCTA
GGTGTTGTGCA -> GTGTTGTGCAT
GGTTAAAGATT -> GTTAAAGATTT
GGTTAACCATG -> GTTAACCATGC
GGTTAATATCT -> GTTAATATCTC
GGTTAATCGCG -> GTTAATCGCGT
GGTTATTGCAA -> GTTATTGCAAA
GGTTCAATAAA -> GTTCAATAAAC
GGTTCTAGCGT -> GTTCTAGCGTG
GGTTGTAATAG -> GTTGTAATAGC
GGTTGTGTGGC -> GTTGTGTGGCG
GTAACACGGAG -> TAACACGGAGA
GTAACCCCGAC -> TAACCCCGACC
GTAACTGCGAT -> TAACTGCGATA
GTAAGAGTTGC -> TAAGAGTTGCT
GTAAGCGGCTG -> TAAGCGGCTGT
GTAAGCTTAAT -> TAAGCTTAATA
GTAATAGCCAT -> TAATAGCCATG
GTACACTTTAT -> TACACTTTATT
GTACGGATCCA -> TACGGATCCAC
GTAGAAGTCGC -> TAGAAGTCGCA
GTAGACAACAC -> TAGACAACACT
GTAGATCTAAG -> TAGATCTAAGT
GTAGCGACGGT -> TAGCGACGGTG
GTAGCGAGGGA -> TAGCGAGGGAC
GTAGCGTCGTT -> TAGCGTCGTTA
GTAGGCTGTGC -> TAGGCTGTGCA
GTAGTGGGACG -> TAGTGGGACGT
GTATCGAGCCC -> TATCGAGCCCT
GTATCTTCAAA -> TATCTTCAAAA
GTATGGTGGGC -> TATGGTGGGCG
GTCAATGAGAT -> TCAATGAGATT
GTCACCGAGTT -> TCACCGAGTTT
GTCACCTCTCA -> TCACCTCTCAT
GTCACGACTCT -> TCACGACTCTC
GTCACTCAAGC -> TCACTCAAGCG
GTCAGCTACTA -> TCAGCTACTAT
GTCAGGGTCAC -> TCAGGGTCACT
GTCAGGGTCCG -> TCAGGGTCCGA
GTCATGAGTAG -> TCATGAGTAGC
GTCATGGGCTA -> TCATGGGCTAA
GTCATTTAACA -> TCATTTAACAG
GTCCAAGGCGC -> TCCAAGGCGCG
GTCCACGTCGA -> TCCACGTCGAA
GTCCACGTGCG -> TCCACGTGCGT
GTCCAGGTTAA -> TCCAGGTTAAC
GTCCATTCTTA -> TCCATTCTTAA
GTCCGACTGTT -> TCCGACTGTTA
GTCCGCGTCGT -> TCCGCGTCGTG
GTCCGCTGGTA -> TCCGCTGGTAG
GTCCTAACCTT -> TCCTAACCTTA
GTCCTATAATT -> TCCTATAATTT
GTCGAAAGGTG -> TCGAAAGGTGG
GTCGACATCGG -> TCGACATCGGT
GTCGCAATGTG -> TCGCAATGTGG
GTCGCTCCCAC -> TCGCTCCCACG
GTCGGAGCCCG -> TCGGAGCCCGT
GTCGTGCCTGC -> TCGTGCCTGCA
GTCGTGGCGAA -> TCGTGGCGAAA
GTCGTTACGTC -> TCGTTACGTCC
GTCGTTAGTGA -> TCGTTAGTGAG
GTCTAGAACAA -> TCTAGAACAAG
GTCTGCTTGTC -> TCTGCTTGTCA
GTCTGGCCCCC -> TCTGGCCCCCT
GTCTTCGAAGT -> TCTTCGAAGTG
GTCTTTAAGGC -> TCTTTAAGGCG
GTGAACCCGAC -> TGAACCCGACC
GTGACGCTACG -> TGACGCTACGT
GTGACTTAGTC -> TGACTTAGTCC
GTGAGCTGCAG -> TGAGCTGCAGG
GTGAGGTTCTA -> TGAGGTTCTAG
GTGAGTCTGGC -> TGAGTCTGGCC
GTGAGTTGTTG -> TGAGTTGTTGG
GTGCAGGCGCT -> TGCAGGCGCTA
GTGCATGACAT -> TGCATGACATC
GTGCATTGGTG -> TGCATTGGTGT
GTGCCAGGCGA -> TGCCAGGCGAC
GTGCCCGTTCA -> TGCCCGTTCAA
GTGCCGTCAAT -> TGCCGTCAATG
GTGCCTGCACC -> TGCCTGCACCT
GTGCGTCTGCT -> TGCGTCTGCTT
GTGGAAGTGCC -> TGGAAGTGCCC
GTGGACCAGCT -> TGGACCAGCTA
GTGGACTCCAA -> TGGACTCCAAA
GTGGCGAAAGA -> TGGCGAAAGAG
GTGGCGATCAG -> TGGCGATCAGA
GTGGCTATTTT -> TGGCTATTTTG
GTGGGAATGCC -> TGGGAATGCCG
GTGGGACGTTC -> TGGGACGTTCT
GTGGGAGACCG -> TGGGAGACCGC
GTGGGATGTGT -> TGGGATGTGTA
GTGGGCGCTCA -> TGGGCGCTCAG
GTGGGCGGAGG -> TGGGCGGAGGT
GTGGGCGTCTA -> TGGGCGTCTAG
GTGGGCTCATG -> TGGGCTCATGA
GTGGGCTGGCT -> TGGGCTGGCTT
GTGGGTGGGCG -> TGGGTGGGCGT
GTGGGTTAATC -> TGGGTTAATCG
GTGGTCGTTAG -> TGGTCGTTAGT
GTGGTGCCAGG -> TGGTGCCAGGC
GTGGTTGTGTG -> TGGTTGTGTGG
GTGTAAGCTTA -> TGTAAGCTTAA
GTGTAGACAAC -> TGTAGACAACA
GTGTATGGTGG -> TGTATGGTGGG
GTGTCACCTCT -> TGTCACCTCTC
GTGTCGACATC -> TGTCGACATCG
GTGTGACGCTA -> TGTGACGCTAC
GTGTGCAGGCG -> TGTGCAGGCGC
GTGTGGCGATC -> TGTGGCGATCA
GTGTGTTGCAC -> TGTGTTGCACA
GTGTTGCACAT -> TGTTGCACATC
GTGTTGTAAGA -> TGTTGTAAGAG
GTGTTGTGCAT -> TGTTGTGCATG
GTGTTTTTTCG -> TGTTTTTTCGA
GTTAAAGATTT -> TTAAAGATTTA
GTTAACCATGC -> TTAACCATGCC
GTTAAGCCCGG -> TTAAGCCCGGG
GTTAATAGAAC -> TTAATAGAACA
GTTAATATCTC -> TTAATATCTCT
GTTAATCGCGT -> TTAATCGCGTG
GTTACGCCGTA -> TTACGCCGTAC
GTTACGTCCAA -> TTACGTCCAAG
GTTAGAAGCTC -> TTAGAAGCTCA
GTTAGGTCAGG -> TTAGGTCAGGG
GTTAGTGAGTT -> TTAGTGAGTTG
GTTATTATGTG -> TTATTATGTGT
GTTATTGCAAA -> TTATTGCAAAA
GTTCAAGTTTG -> TTCAAGTTTGA
GTTCAATAAAC -> TTCAATAAACA
GTTCAATGCTG -> TTCAATGCTGA
GTTCACCGACA -> TTCACCGACAG
GTTCGCCAAAC -> TTCGCCAAACC
GTTCTAGCGTG -> TTCTAGCGTGA
GTTCTAGTCGG -> TTCTAGTCGGA
GTTCTGCGTCG -> TTCTGCGTCGC
GTTCTTAATAA -> TTCTTAATAAA
GTTGCACATCG -> TTGCACATCGA
GTTGCTAGGTC -> TTGCTAGGTCT
GTTGCTTCCAG -> TTGCTTCCAGC
GTTGGAAAGTC -> TTGGAAAGTCC
GTTGGACATTG -> TTGGACATTGA
GTTGGTTGTAA -> TTGGTTGTAAT
GTTGTAAGAGT -> TTGTAAGAGTT
GTTGTAATAGC -> TTGTAATAGCC
GTTGTGCATGA -> TTGTGCATGAC
GTTGTGTGGCG -> TTGTGTGGCGA
GTTGTTGGACA -> TTGTTGGACAT
GTTTAACGCAC -> TTTAACGCACC
GTTTATAAAGC -> TTTATAAAGCC
GTTTATGCTCC -> TTTATGCTCCT
GTTTGACATCC -> TTTGACATCCT
GTTTGACCCCT -> TTTGACCCCTC
GTTTTACGTGT -> TTTTACGTGTA
GTTTTGCCAAA -> TTTTGCCAAAT
GTTTTTTCGAC -> TTTTTTCGACC
TAAAAACCTGC -> AAAAACCTGCA
TAAAACTTTGT -> AAAACTTTGTT
TAAAATGAGTA -> AAAATGAGTAT
TAAACATCGTG -> AAACATCGTGT
TAAAGATTTAA -> AAAGATTTAAG
TAAAGCAGCCT -> AAAGCAGCCTA
TAAAGCCAGAA -> AAAGCCAGAAC
TAAATAAAGCA -> AAATAAAGCAG
TAAATGAAAAT -> AAATGAAAATT
TAAATGCATCG -> AAATGCATCGG
TAACACGGAGA -> AACACGGAGAG
TAACAGATGTG -> AACAGATGTGG
TAACCATGCCC -> AACCATGCCCT
TAACCCCGACC -> AACCCCGACCC
TAACCTTACTG -> AACCTTACTGC
TAACGCACCTA -> AACGCACCTAC
TAACGTGAGGT -> AACGTGAGGTT
TAACTCACTTG -> AACTCACTTGC
TAACTGCGATA -> AACTGCGATAT
TAAGAGTTGCT -> AAGAGTTGCTT
TAAGCAACCTT -> AAGCAACCTTT
TAAGCAGAGTT -> AAGCAGAGTTA
TAAGCAGCCGA -> AAGCAGCCGAG
TAAGCCAGGAA -> AAGCCAGGAAG
TAAGCCCGGGC -> AAGCCCGGGCT
TAAGCCTTGTA -> AAGCCTTGTAG
TAAGCGACACC -> AAGCGACACCA
TAAGCGGCTGT -> AAGCGGCTGTT
TAAGCTTAATA -> AAGCTTAATAT
TAAGGCGCAAG -> AAGGCGCAAGT
TAAGTAACCCC -> AAGTAACCCCG
TAAGTTCAATG -> AAGTTCAATGC
TAATAAAAACC -> AATAAAAACCT
TAATAAATGCA -> AATAAATGCAT
TAATAGAACAT -> AATAGAACATG
TAATAGCCATG -> AATAGCCATGA
TAATATCTCTG -> AATATCTCTGA
TAATATGAACG -> AATATGAACGA
TAATCGCGTGT -> AATCGCGTGTT
TAATGCCCGGC -> AATGCCCGGCC
TAATTGGTTAT -> AATTGGTTATT
TAATTGTTTAT -> AATTGTTTATG
TAATTTGCGGA -> AATTTGCGGAT
TACAAGCACGC -> ACAAGCACGCT
TACACTTTATT -> ACACTTTATTC
TACAGACTTAA -> ACAGACTTAAG
TACCACCTGGT -> ACCACCTGGTA
TACCCCACGTG -> ACCCCACGTGA
TACCGGAATTG -> ACCGGAATTGA
TACCGTCCTAT -> ACCGTCCTATA
TACGAGCTAAA -> ACGAGCTAAAT
TACGCCGTACA -> ACGCCGTACAC
TACGGATCCAC -> ACGGATCCACA
TACGGGAGTTA -> ACGGGAGTTAT
TACGGGAGTTC -> ACGGGAGTTCG
TACGTCCAAGG -> ACGTCCAAGGC
TACGTCTTTAA -> ACGTCTTTAAG
TACGTGTAAGC -> ACGTGTAAGCT
TACGTTTTACG -> ACGTTTTACGT
TACTATCTCTA -> ACTATCTCTAG
TACTATTATCA -> ACTATTATCAA
TACTGCCTACT -> ACTGCCTACTA
TAGAACAAGGA -> AGAACAAGGAT
TAGAACATGAA -> AGAACATGAAA
TAGAACCGTTA -> AGAACCGTTAA
TAGAACGGGTC -> AGAACGGGTCA
TAGAAGCTCAT -> AGAAGCTCATT
TAGAAGTCGCA -> AGAAGTCGCAA
TAGAATTGAGT -> AGAATTGAGTG
TAGACAACACT -> AGACAACACTA
TAGAGCGCGTG -> AGAGCGCGTGT
TAGATCTAAGT -> AGATCTAAGTA
TAGATGCTCGG -> AGATGCTCGGT
TAGCCATGAGA -> AGCCATGAGAA
TAGCGACGGTG -> AGCGACGGTGG
TAGCGAGGGAC -> AGCGAGGGACG
TAGCGGCTCTA -> AGCGGCTCTAC
TAGCGTCGTTA -> AGCGTCGTTAC
TAGCGTGACTT -> AGCGTGACTTA
TAGCTGTGGAA -> AGCTGTGGAAG
TAGGCTCTCTG -> AGGCTCTCTGT
TAGGCTGTGCA -> AGGCTGTGCAT
TAGGGAGCAAT -> AGGGAGCAATG
TAGGGCGCGGG -> AGGGCGCGGGG
TAGGTCAGGGT -> AGGTCAGGGTC
TAGGTCTTCGA -> AGGTCTTCGAA
TAGGTGTATGG -> AGGTGTATGGT
TAGTACGGATC -> AGTACGGATCC
TAGTCCAGGTT -> AGTCCAGGTTA
TAGTCGGAGCC -> AGTCGGAGCCC
TAGTGAGTTGT -> AGTGAGTTGTT
TAGTGGGACGT -> AGTGGGACGTT
TATAAAGCCAG -> ATAAAGCCAGA
TATAATTTGCG -> ATAATTTGCGG
TATATCTCGCT -> ATATCTCGCTG
TATCAAAAATC -> ATCAAAAATCC
TATCGAGCCCT -> ATCGAGCCCTA
TATCGTTTGAC -> ATCGTTTGACC
TATCTCGCTGG -> ATCTCGCTGGA
TATCTCTAGAA -> ATCTCTAGAAC
TATCTCTGAGT -> ATCTCTGAGTT
TATCTTCAAAA -> ATCTTCAAAAC
TATGAACGATT -> ATGAACGATTC
TATGCTCCTGC -> ATGCTCCTGCT
TATGGGCCCAG -> ATGGGCCCAGC
TATGGGGGGGA -> ATGGGGGGGAC
TATGGTGGGCG -> ATGGTGGGCGG
TATGTCCACGT -> ATGTCCACGTC
TATGTGTCACC -> ATGTGTCACCT
TATTATCAAAA -> ATTATCAAAAA
TATTATGTGTC -> ATTATGTGTCA
TATTCTGGCTG -> ATTCTGGCTGT
TATTCTGTCCG -> ATTCTGTCCGC
TATTGCAAAAG -> ATTGCAAAAGT
TATTTTGCTGC -> ATTTTGCTGCG
TCAAAAATCCC -> CAAAAATCCCA
TCAAAACCGTC -> CAAAACCGTCA
TCAAGAGAACT -> CAAGAGAACTT
TCAAGCGTCCG -> CAAGCGTCCGC
TCAAGTTTGAC -> CAAGTTTGACA
TCAATAAACAT -> CAATAAACATC
TCAATGAGATT -> CAATGAGATTC
TCAATGCTGAT -> CAATGCTGATG
TCACCCCCGAG -> CACCCCCGAGC
TCACCGACAGG -> CACCGACAGGT
TCACCGAGACC -> CACCGAGACCC
TCACCGAGTTT -> CACCGAGTTTT
TCACCTCTCAT -> CACCTCTCATG
TCACGACTCTC -> CACGACTCTCC
TCACTCAAGCG -> CACTCAAGCGT
TCACTTGCTGA -> CACTTGCTGAT
TCAGAAAATAA -> CAGAAAATAAC
TCAGATTCTCG -> CAGATTCTCGA
TCAGCACGTAT -> CAGCACGTATC
TCAGCTACTAT -> CAGCTACTATC
TCAGGATCGTC -> CAGGATCGTCA
TCAGGGTCACT -> CAGGGTCACTC
TCAGGGTCCGA -> CAGGGTCCGAC
TCATCGATGGG -> CATCGATGGGA
TCATCTGTCCA -> CATCTGTCCAT
TCATGACAATA -> CATGACAATAG
TCATGAGCACC -> CATGAGCACCT
TCATGAGTAGC -> CATGAGTAGCG
TCATGATTAAG -> CATGATTAAGC
TCATGGGCTAA -> CATGGGCTAAA
TCATGTTCTTA -> CATGTTCTTAA
TCATTACCCCA -> CATTACCCCAC
TCATTTAACAG -> CATTTAACAGA
TCCAAACTACC -> CCAAACTACCG
TCCAAGGCGCG -> CCAAGGCGCGT
TCCACAATTGA -> CCACAATTGAT
TCCACCCCCAT -> CCACCCCCATC
TCCACGTCGAA -> CCACGTCGAAA
TCCACGTGCGT -> CCACGTGCGTC
TCCAGCTCGTC -> CCAGCTCGTCG
TCCAGGTTAAC -> CCAGGTTAACC
TCCATTCTTAA -> CCATTCTTAAA
TCCCAAGACCT -> CCCAAGACCTA
TCCCACGACCT -> CCCACGACCTT
TCCCACTCCGA -> CCCACTCCGAC
TCCGACGCGCG -> CCGACGCGCGG
TCCGACTGTTA -> CCGACTGTTAG
TCCGCGTCGTG -> CCGCGTCGTGG
TCCGCTGGTAG -> CCGCTGGTAGT
TCCGGTGGGAA -> CCGGTGGGAAT
TCCTAACCTTA -> CCTAACCTTAC
TCCTAGCGGCT -> CCTAGCGGCTC
TCCTATAATTT -> CCTATAATTTG
TCCTGAGGTGT -> CCTGAGGTGTG
TCCTGAGTTAC -> CCTGAGTTACG
TCCTGCTTTTC -> CCTGCTTTTCT
TCCTGGGCTTA -> CCTGGGCTTAT
TCCTGTGGCTA -> CCTGTGGCTAT
TCCTTCTAGGG -> CCTTCTAGGGC
TCGAAAGGTGG -> CGAAAGGTGGG
TCGAAGTGGGT -> CGAAGTGGGTG
TCGACATCGGT -> CGACATCGGTA
TCGACCATCGG -> CGACCATCGGA
TCGAGCCCTAA -> CGAGCCCTAAG
TCGAGTGGGCG -> CGAGTGGGCGC
TCGATAATAAA -> CGATAATAAAT
TCGATGGGACG -> CGATGGGACGG
TCGCAATGTGG -> CGCAATGTGGG
TCGCCAAACCT -> CGCCAAACCTA
TCGCGTGTTTT -> CGCGTGTTTTT
TCGCTCCCACG -> CGCTCCCACGA
TCGCTGGACGG -> CGCTGGACGGG
TCGGAGCCCGT -> CGGAGCCCGTT
TCGGAGCCTAG -> CGGAGCCTAGG
TCGGAGTGGAC -> CGGAGTGGACT
TCGGTAGCGAG -> CGGTAGCGAGG
TCGGTCAGCTA -> CGGTCAGCTAC
TCGGTTCAATA -> CGGTTCAATAA
TCGTAAGCGGC -> CGTAAGCGGCT
TCGTCACGACT -> CGTCACGACTC
TCGTCGTGCCT -> CGTCGTGCCTG
TCGTGCCTGCA -> CGTGCCTGCAC
TCGTGGCGAAA -> CGTGGCGAAAG
TCGTGTGTTGC -> CGTGTGTTGCA
TCGTGTTGTAA -> CGTGTTGTAAG
TCGTTACGTCC -> CGTTACGTCCA
TCGTTAGTGAG -> CGTTAGTGAGT
TCGTTTGACCC -> CGTTTGACCCC
TCTAAGTAACC -> CTAAGTAACCC
TCTAAGTTCAA -> CTAAGTTCAAT
TCTACCACCTG -> CTACCACCTGG
TCTAGAACAAG -> CTAGAACAAGG
TCTAGAACGGG -> CTAGAACGGGT
TCTAGCGTGAC -> CTAGCGTGACT
TCTAGGCTCTC -> CTAGGCTCTCT
TCTAGGGCGCG -> CTAGGGCGCGG
TCTAGTCGGAG -> CTAGTCGGAGC
TCTCATGAGCA -> CTCATGAGCAC
TCTCCGGTGGG -> CTCCGGTGGGA
TCTCCTGAGGT -> CTCCTGAGGTG
TCTCGAGTGGG -> CTCGAGTGGGC
TCTCGCTGGAC -> CTCGCTGGACG
TCTCTAGAACG -> CTCTAGAACGG
TCTCTAGGCTC -> CTCTAGGCTCT
TCTCTGAGTTG -> CTCTGAGTTGG
TCTCTGTTTAT -> CTCTGTTTATA
TCTGAACCAAC -> CTGAACCAACT
TCTGAGTTGGA -> CTGAGTTGGAA
TCTGCGTCGCT -> CTGCGTCGCTC
TCTGCTTGTCA -> CTGCTTGTCAC
TCTGGCCCCCT -> CTGGCCCCCTC
TCTGGCTGTCA -> CTGGCTGTCAG
TCTGTCCATTC -> CTGTCCATTCT
TCTGTCCGCTG -> CTGTCCGCTGG
TCTGTTTATAA -> CTGTTTATAAA
TCTTAAAATGA -> CTTAAAATGAG
TCTTAATAAAA -> CTTAATAAAAA
TCTTCAAAACC -> CTTCAAAACCG
TCTTCGAAGTG -> CTTCGAAGTGG
TCTTTAAGGCG -> CTTTAAGGCGC
TGAAAATTCAA -> GAAAATTCAAG
TGAAAGCTTCT -> GAAAGCTTCTA
TGAACCAACTC -> GAACCAACTCA
TGAACCCGACC -> GAACCCGACCA
TGAACGATTCA -> GAACGATTCAT
TGAAGCTCAGC -> GAAGCTCAGCA
TGAAGTGGACC -> GAAGTGGACCA
TGACAATAGTA -> GACAATAGTAC
TGACATCCTTC -> GACATCCTTCT
TGACATCGGAG -> GACATCGGAGT
TGACCCCTCAC -> GACCCCTCACC
TGACGCTACGT -> GACGCTACGTT
TGACTAATGCC -> GACTAATGCCC
TGACTCCTAGC -> GACTCCTAGCG
TGACTTAGTCC -> GACTTAGTCCA
TGAGAATCAGA -> GAGAATCAGAA
TGAGATTCGTA -> GAGATTCGTAA
TGAGCACCTCG -> GAGCACCTCGT
TGAGCTGCAGG -> GAGCTGCAGGA
TGAGGCTTTGC -> GAGGCTTTGCG
TGAGGTGTGAC -> GAGGTGTGACG
TGAGGTTCTAG -> GAGGTTCTAGC
TGAGTAGCGTC -> GAGTAGCGTCG
TGAGTATCTTC -> GAGTATCTTCA
TGAGTCTGGCC -> GAGTCTGGCCC
TGAGTGGTTGT -> GAGTGGTTGTG
TGAGTTACGCC -> GAGTTACGCCG
TGAGTTGGAAA -> GAGTTGGAAAG
TGAGTTGTTGG -> GAGTTGTTGGA
TGATAACGTGA -> GATAACGTGAG
TGATCATGACA -> GATCATGACAA
TGATCCTGGGC -> GATCCTGGGCT
TGATGTTCACC -> GATGTTCACCG
TGATTAAGCAG -> GATTAAGCAGA
TGCAAAAGTGG -> GCAAAAGTGGG
TGCACATCGAT -> GCACATCGATA
TGCACCTAGAT -> GCACCTAGATG
TGCAGGAATAA -> GCAGGAATAAT
TGCAGGCGCTA -> GCAGGCGCTAC
TGCATCCTGAG -> GCATCCTGAGT
TGCATCGGTCA -> GCATCGGTCAG
TGCATCTCCGG -> GCATCTCCGGT
TGCATGACATC -> GCATGACATCG
TGCATTGAAGC -> GCATTGAAGCT
TGCATTGGTGT -> GCATTGGTGTT
TGCCAAATAAG -> GCCAAATAAGC
TGCCAGGCGAC -> GCCAGGCGACT
TGCCCGGCCCG -> GCCCGGCCCGT
TGCCCGTTCAA -> GCCCGTTCAAG
TGCCCTCATCG -> GCCCTCATCGA
TGCCGTCAATG -> GCCGTCAATGA
TGCCGTCATTT -> GCCGTCATTTA
TGCCTACTATT -> GCCTACTATTA
TGCCTGCACCT -> GCCTGCACCTA
TGCGATATATC -> GCGATATATCT
TGCGCAGCGGC -> GCGCAGCGGCA
TGCGGATGTGG -> GCGGATGTGGG
TGCGTCGCTCC -> GCGTCGCTCCC
TGCGTCTGCTT -> GCGTCTGCTTG
TGCGTTGGTTG -> GCGTTGGTTGT
TGCTAGGTCTT -> GCTAGGTCTTC
TGCTCCTGCTT -> GCTCCTGCTTT
TGCTCGGTTCA -> GCTCGGTTCAA
TGCTGATCCTG -> GCTGATCCTGG
TGCTGATGTTC -> GCTGATGTTCA
TGCTGCGTTGG -> GCTGCGTTGGT
TGCTTCCAGCT -> GCTTCCAGCTC
TGCTTGTCACC -> GCTTGTCACCG
TGCTTTTCTCT -> GCTTTTCTCTA
TGGAAAGTCCT -> GGAAAGTCCTA
TGGAAGTGCCC -> GGAAGTGCCCG
TGGACATTGAC -> GGACATTGACT
TGGACCAGCTA -> GGACCAGCTAT
TGGACTCCAAA -> GGACTCCAAAC
TGGCCCCCTCC -> GGCCCCCTCCT
TGGCGAAAGAG -> GGCGAAAGAGA
TGGCGATCAGA -> GGCGATCAGAT
TGGCTATTTTG -> GGCTATTTTGC
TGGCTGTCAGG -> GGCTGTCAGGG
TGGCTTAGAAC -> GGCTTAGAACC
TGGGAATGCCG -> GGGAATGCCGT
TGGGACGGGCC -> GGGACGGGCCC
TGGGACGTTCT -> GGGACGTTCTA
TGGGAGACCGC -> GGGAGACCGCT
TGGGATGTGTA -> GGGATGTGTAG
TGGGCCCAGCG -> GGGCCCAGCGA
TGGGCGCTCAG -> GGGCGCTCAGG
TGGGCGGAGGT -> GGGCGGAGGTC
TGGGCGTCTAG -> GGGCGTCTAGA
TGGGCTAAAAC -> GGGCTAAAACT
TGGGCTCATGA -> GGGCTCATGAT
TGGGCTGGCTT -> GGGCTGGCTTA
TGGGCTTATGG -> GGGCTTATGGG
TGGGGGGGACA -> GGGGGGGACAG
TGGGTAGCGAC -> GGGTAGCGACG
TGGGTGGGCGT -> GGGTGGGCGTC
TGGGTTAATCG -> GGGTTAATCGC
TGGTAGATCTA -> GGTAGATCTAA
TGGTAGTGGGA -> GGTAGTGGGAC
TGGTCGTTAGT -> GGTCGTTAGTG
TGGTGCCAGGC -> GGTGCCAGGCG
TGGTGGGCGGA -> GGTGGGCGGAG
TGGTGTTGTGC -> GGTGTTGTGCA
TGGTTATTGCA -> GGTTATTGCAA
TGGTTGTAATA -> GGTTGTAATAG
TGGTTGTGTGG -> GGTTGTGTGGC
TGTAAGAGTTG -> GTAAGAGTTGC
TGTAAGCTTAA -> GTAAGCTTAAT
TGTAATAGCCA -> GTAATAGCCAT
TGTAGAAGTCG -> GTAGAAGTCGC
TGTAGACAACA -> GTAGACAACAC
TGTATGGTGGG -> GTATGGTGGGC
TGTCACCGAGT -> GTCACCGAGTT
TGTCACCTCTC -> GTCACCTCTCA
TGTCAGGGTCC -> GTCAGGGTCCG
TGTCCACGTCG -> GTCCACGTCGA
TGTCCATTCTT -> GTCCATTCTTA
TGTCCGCTGGT -> GTCCGCTGGTA
TGTCGACATCG -> GTCGACATCGG
TGTGAACCCGA -> GTGAACCCGAC
TGTGACGCTAC -> GTGACGCTACG
TGTGCAGGCGC -> GTGCAGGCGCT
TGTGCATGACA -> GTGCATGACAT
TGTGCATTGGT -> GTGCATTGGTG
TGTGGAAGTGC -> GTGGAAGTGCC
TGTGGCGATCA -> GTGGCGATCAG
TGTGGCTATTT -> GTGGCTATTTT
TGTGGGAGACC -> GTGGGAGACCG
TGTGGGCTCAT -> GTGGGCTCATG
TGTGGTGCCAG -> GTGGTGCCAGG
TGTGTAGACAA -> GTGTAGACAAC
TGTGTCACCTC -> GTGTCACCTCT
TGTGTGGCGAT -> GTGTGGCGATC
TGTGTTGCACA -> GTGTTGCACAT
TGTTAGGTCAG -> GTTAGGTCAGG
TGTTCACCGAC -> GTTCACCGACA
TGTTCTGCGTC -> GTTCTGCGTCG
TGTTCTTAATA -> GTTCTTAATAA
TGTTGCACATC -> GTTGCACATCG
TGTTGCTAGGT -> GTTGCTAGGTC
TGTTGGACATT -> GTTGGACATTG
TGTTGTAAGAG -> GTTGTAAGAGT
TGTTGTGCATG -> GTTGTGCATGA
TGTTTATAAAG -> GTTTATAAAGC
TGTTTATGCTC -> GTTTATGCTCC
TGTTTTTTCGA -> GTTTTTTCGAC
TTAAAATGAGT -> TAAAATGAGTA
TTAAAGATTTA -> TAAAGATTTAA
TTAACAGATGT -> TAACAGATGTG
TTAACCATGCC -> TAACCATGCCC
TTAACGCACCT -> TAACGCACCTA
TTAAGCAACCT -> TAAGCAACCTT
TTAAGCAGAGT -> TAAGCAGAGTT
TTAAGCCAGGA -> TAAGCCAGGAA
TTAAGCCCGGG -> TAAGCCCGGGC
TTAAGCGACAC -> TAAGCGACACC
TTAAGGCGCAA -> TAAGGCGCAAG
TTAATAAAAAC -> TAATAAAAACC
TTAATAGAACA -> TAATAGAACAT
TTAATATCTCT -> TAATATCTCTG
TTAATATGAAC -> TAATATGAACG
TTAATCGCGTG -> TAATCGCGTGT
TTACCCCACGT -> TACCCCACGTG
TTACCGGAATT -> TACCGGAATTG
TTACGAGCTAA -> TACGAGCTAAA
TTACGCCGTAC -> TACGCCGTACA
TTACGTCCAAG -> TACGTCCAAGG
TTACGTGTAAG -> TACGTGTAAGC
TTACTGCCTAC -> TACTGCCTACT
TTAGAACCGTT -> TAGAACCGTTA
TTAGAAGCTCA -> TAGAAGCTCAT
TTAGGTCAGGG -> TAGGTCAGGGT
TTAGTCCAGGT -> TAGTCCAGGTT
TTAGTGAGTTG -> TAGTGAGTTGT
TTATAAAGCCA -> TATAAAGCCAG
TTATCAAAAAT -> TATCAAAAATC
TTATGCTCCTG -> TATGCTCCTGC
TTATGGGCCCA -> TATGGGCCCAG
TTATGTGTCAC -> TATGTGTCACC
TTATTATGTGT -> TATTATGTGTC
TTATTCTGGCT -> TATTCTGGCTG
TTATTGCAAAA -> TATTGCAAAAG
TTCAAAACCGT -> TCAAAACCGTC
TTCAAGAGAAC -> TCAAGAGAACT
TTCAAGTTTGA -> TCAAGTTTGAC
TTCAATAAACA -> TCAATAAACAT
TTCAATGCTGA -> TCAATGCTGAT
TTCACCGACAG -> TCACCGACAGG
TTCATGTTCTT -> TCATGTTCTTA
TTCCACCCCCA -> TCCACCCCCAT
TTCCAGCTCGT -> TCCAGCTCGTC
TTCGAAGTGGG -> TCGAAGTGGGT
TTCGACCATCG -> TCGACCATCGG
TTCGCCAAACC -> TCGCCAAACCT
TTCGTAAGCGG -> TCGTAAGCGGC
TTCTAAGTTCA -> TCTAAGTTCAA
TTCTAGCGTGA -> TCTAGCGTGAC
TTCTAGGGCGC -> TCTAGGGCGCG
TTCTAGTCGGA -> TCTAGTCGGAG
TTCTCGAGTGG -> TCTCGAGTGGG
TTCTCTAGGCT -> TCTCTAGGCTC
TTCTGCGTCGC -> TCTGCGTCGCT
TTCTGGCTGTC -> TCTGGCTGTCA
TTCTGTCCGCT -> TCTGTCCGCTG
TTCTTAAAATG -> TCTTAAAATGA
TTCTTAATAAA -> TCTTAATAAAA
TTGAAGCTCAG -> TGAAGCTCAGC
TTGAAGTGGAC -> TGAAGTGGACC
TTGACATCCTT -> TGACATCCTTC
TTGACCCCTCA -> TGACCCCTCAC
TTGACTAATGC -> TGACTAATGCC
TTGACTCCTAG -> TGACTCCTAGC
TTGAGTGGTTG -> TGAGTGGTTGT
TTGATAACGTG -> TGATAACGTGA
TTGCAAAAGTG -> TGCAAAAGTGG
TTGCACATCGA -> TGCACATCGAT
TTGCATCCTGA -> TGCATCCTGAG
TTGCATTGAAG -> TGCATTGAAGC
TTGCCAAATAA -> TGCCAAATAAG
TTGCGCAGCGG -> TGCGCAGCGGC
TTGCGGATGTG -> TGCGGATGTGG
TTGCTAGGTCT -> TGCTAGGTCTT
TTGCTGATCCT -> TGCTGATCCTG
TTGCTGCGTTG -> TGCTGCGTTGG
TTGCTTCCAGC -> TGCTTCCAGCT
TTGGAAAGTCC -> TGGAAAGTCCT
TTGGACATTGA -> TGGACATTGAC
TTGGTGTTGTG -> TGGTGTTGTGC
TTGGTTATTGC -> TGGTTATTGCA
TTGGTTGTAAT -> TGGTTGTAATA
TTGTAAGAGTT -> TGTAAGAGTTG
TTGTAATAGCC -> TGTAATAGCCA
TTGTAGAAGTC -> TGTAGAAGTCG
TTGTCACCGAG -> TGTCACCGAGT
TTGTGCATGAC -> TGTGCATGACA
TTGTGTGGCGA -> TGTGTGGCGAT
TTGTTGCTAGG -> TGTTGCTAGGT
TTGTTGGACAT -> TGTTGGACATT
TTGTTTATGCT -> TGTTTATGCTC
TTTAACAGATG -> TTAACAGATGT
TTTAACGCACC -> TTAACGCACCT
TTTAAGCCAGG -> TTAAGCCAGGA
TTTAAGGCGCA -> TTAAGGCGCAA
TTTACGTGTAA -> TTACGTGTAAG
TTTATAAAGCC -> TTATAAAGCCA
TTTATGCTCCT -> TTATGCTCCTG
TTTATTCTGGC -> TTATTCTGGCT
TTTCCACCCCC -> TTCCACCCCCA
TTTCGACCATC -> TTCGACCATCG
TTTCTCTAGGC -> TTCTCTAGGCT
TTTGACATCCT -> TTGACATCCTT
TTTGACCCCTC -> TTGACCCCTCA
TTTGCATCCTG -> TTGCATCCTGA
TTTGCCAAATA -> TTGCCAAATAA
TTTGCGCAGCG -> TTGCGCAGCGG
TTTGCGGATGT -> TTGCGGATGTG
TTTGCTGCGTT -> TTGCTGCGTTG
TTTGTTGCTAG -> TTGTTGCTAGG
TTTTACGTGTA -> TTTACGTGTAA
TTTTCGACCAT -> TTTCGACCATC
TTTTCTCTAGG -> TTTCTCTAGGC
TTTTGCCAAAT -> TTTGCCAAATA
TTTTGCTGCGT -> TTTGCTGCGTT
TTTTTCGACCA -> TTTTCGACCAT
TTTTTTCGACC -> TTTTTCGACCA
