CCGAATTTTCATCGTTGCTT -> CGAATTTTCATCGTTGCTTT
AAAACCCGGAAACTCGTATA -> AAACCCGGAAACTCGTATAT
AAAAGCTGAAAATACAGACA -> AAAGCTGAAAATACAGACAT
AAAATACAGACATGACTTAC -> AAATACAGACATGACTTACC
AAAATCTCGATGCAATGGAG -> AAATCTCGATGCAATGGAGA
AAACATAACAGTGTTGCACC -> AACATAACAGTGTTGCACCA
AAACCCGACGTCATCGCCAG -> AACCCGACGTCATCGCCAGG
AAACCCGGAAACTCGTATAT -> AACCCGGAAACTCGTATATA
AAACTCGTATATATGAACAG -> AACTCGTATATATGAACAGC
AAACTGCTAACCGAGAGGTT -> AACTGCTAACCGAGAGGTTA
AAAGCTGAAAATACAGACAT -> AAGCTGAAAATACAGACATG
AAATACAGACATGACTTACC -> AATACAGACATGACTTACCT
AAATCAAGTAGTCATTGAGG -> AATCAAGTAGTCATTGAGGG
AAATCTCGATGCAATGGAGA -> AATCTCGATGCAATGGAGAA
AAATGACTTCTTCCGGAGTT -> AATGACTTCTTCCGGAGTTA
AACACCAGACTTAAGCGTTC -> ACACCAGACTTAAGCGTTCG
AACACTATTTGTGGCCTACA -> ACACTATTTGTGGCCTACAA
AACAGCTGGGACATGATCCC -> ACAGCTGGGACATGATCCCC
AACAGTGTTGCACCATTCTA -> ACAGTGTTGCACCATTCTAC
AACATAACAGTGTTGCACCA -> ACATAACAGTGTTGCACCAT
AACATAACGCTGTATGCTGC -> ACATAACGCTGTATGCTGCA
AACATAACGTACGGCTCGCG -> ACATAACGTACGGCTCGCGC
AACCACAGAGCACTTAAGTC -> ACCACAGAGCACTTAAGTCC
AACCCGACGTCATCGCCAGG -> ACCCGACGTCATCGCCAGGT
AACCCGGAAACTCGTATATA -> ACCCGGAAACTCGTATATAT
AACCGAGAGGTTATTCTAAG -> ACCGAGAGGTTATTCTAAGA
AACGCCCCCAATGTCATGGA -> ACGCCCCCAATGTCATGGAT
AACGCTGTATGCTGCAATTG -> ACGCTGTATGCTGCAATTGA
AACGGCGGCATGGATCTCAT -> ACGGCGGCATGGATCTCATT
AACGTACGGCTCGCGCGGTC -> ACGTACGGCTCGCGCGGTCC
AACTCGTATATATGAACAGC -> ACTCGTATATATGAACAGCT
AACTGCTAACCGAGAGGTTA -> ACTGCTAACCGAGAGGTTAT
AACTTCATGAATGTGACGCT -> ACTTCATGAATGTGACGCTG
AACTTTGGACCCAGTAACAC -> ACTTTGGACCCAGTAACACC
AAGAAAAGCTGAAAATACAG -> AGAAAAGCTGAAAATACAGA
AAGAGCGGTATCCGGAGCTG -> AGAGCGGTATCCGGAGCTGA
AAGATAGGCGCAAAATCTCG -> AGATAGGCGCAAAATCTCGA
AAGATCAGTCGGCAAGTCTT -> AGATCAGTCGGCAAGTCTTC
AAGATGCCTGAATTTCGCCC -> AGATGCCTGAATTTCGCCCC
AAGCGTTCGCTGACTGAATG -> AGCGTTCGCTGACTGAATGC
AAGCTGAAAATACAGACATG -> AGCTGAAAATACAGACATGA
AAGCTTCCAGCTGCAGCTCG -> AGCTTCCAGCTGCAGCTCGA
AAGGGATATGACTAGTAGAG -> AGGGATATGACTAGTAGAGG
AAGTAGTCATTGAGGGAGTA -> AGTAGTCATTGAGGGAGTAT
AAGTCCTCGTGGCGTCTTTC -> AGTCCTCGTGGCGTCTTTCG
AAGTCTTCGATCGGGTAAGG -> AGTCTTCGATCGGGTAAGGT
AAGTGCCTCTACTTACTCAT -> AGTGCCTCTACTTACTCATA
AAGTTAAATCAAGTAGTCAT -> AGTTAAATCAAGTAGTCATT
AATACAGACATGACTTACCT -> ATACAGACATGACTTACCTA
AATAGTGGCGGCAAACTGCT -> ATAGTGGCGGCAAACTGCTA
AATATGACGCAAGCTTCCAG -> ATATGACGCAAGCTTCCAGC
AATCAAGTAGTCATTGAGGG -> ATCAAGTAGTCATTGAGGGA
AATCCGGGAGTCCCATTTTG -> ATCCGGGAGTCCCATTTTGC
AATCTCGATGCAATGGAGAA -> ATCTCGATGCAATGGAGAAT
AATGACTTCTTCCGGAGTTA -> ATGACTTCTTCCGGAGTTAG
AATGCACCCTGGATCATGAC -> ATGCACCCTGGATCATGACA
AATGCCCTTACCCTAATGCA -> ATGCCCTTACCCTAATGCAC
AATGGAGAATAGTGGCGGCA -> ATGGAGAATAGTGGCGGCAA
AATGTCATGGATTCTTATAT -> ATGTCATGGATTCTTATATG
AATGTGACGCTGGGAAGAAA -> ATGTGACGCTGGGAAGAAAA
AATTGAGCCTGACGCATTCG -> ATTGAGCCTGACGCATTCGA
AATTTCGCCCCTCGCCTGAT -> ATTTCGCCCCTCGCCTGATT
AATTTTCATCGTTGCTTTAA -> ATTTTCATCGTTGCTTTAAA
ACAAACATAACAGTGTTGCA -> CAAACATAACAGTGTTGCAC
ACAAACCCGACGTCATCGCC -> CAAACCCGACGTCATCGCCA
ACAAGTTAAATCAAGTAGTC -> CAAGTTAAATCAAGTAGTCA
ACAATATGACGCAAGCTTCC -> CAATATGACGCAAGCTTCCA
ACACCAGACTTAAGCGTTCG -> CACCAGACTTAAGCGTTCGC
ACACTATTTGTGGCCTACAA -> CACTATTTGTGGCCTACAAA
ACAGACATGACTTACCTAGG -> CAGACATGACTTACCTAGGA
ACAGAGCACTTAAGTCCTCG -> CAGAGCACTTAAGTCCTCGT
ACAGCGGTAACATAACGCTG -> CAGCGGTAACATAACGCTGT
ACAGCTGGGACATGATCCCC -> CAGCTGGGACATGATCCCCG
ACAGTGTTGCACCATTCTAC -> CAGTGTTGCACCATTCTACT
ACATAACAGTGTTGCACCAT -> CATAACAGTGTTGCACCATT
ACATAACGCTGTATGCTGCA -> CATAACGCTGTATGCTGCAA
ACATAACGTACGGCTCGCGC -> CATAACGTACGGCTCGCGCG
ACATCGCCAGATTGGGCCAG -> CATCGCCAGATTGGGCCAGC
ACATGACTTACCTAGGAGGG -> CATGACTTACCTAGGAGGGG
ACATGATCCCCGTATACGGT -> CATGATCCCCGTATACGGTA
ACCACAGAGCACTTAAGTCC -> CCACAGAGCACTTAAGTCCT
ACCACCCATGCACCCATCAG -> CCACCCATGCACCCATCAGT
ACCAGACTTAAGCGTTCGCT -> CCAGACTTAAGCGTTCGCTG
ACCATTCTACTGTAGGAGTT -> CCATTCTACTGTAGGAGTTA
ACCCAGTAACACCAGACTTA -> CCCAGTAACACCAGACTTAA
ACCCATCAGTATTGCTACTT -> CCCATCAGTATTGCTACTTG
ACCCATGCACCCATCAGTAT -> CCCATGCACCCATCAGTATT
ACCCGACGTCATCGCCAGGT -> CCCGACGTCATCGCCAGGTC
ACCCGGAAACTCGTATATAT -> CCCGGAAACTCGTATATATG
ACCCTAATGCACCCTGGATC -> CCCTAATGCACCCTGGATCA
ACCCTACTCTTGGTCTACTG -> CCCTACTCTTGGTCTACTGC
ACCCTGGATCATGACAAACA -> CCCTGGATCATGACAAACAT
ACCGAGAGGTTATTCTAAGA -> CCGAGAGGTTATTCTAAGAT
ACCTAGCGACGTCTTGCCCA -> CCTAGCGACGTCTTGCCCAT
ACCTAGGAGGGGCGCCCCGG -> CCTAGGAGGGGCGCCCCGGC
ACCTCTCTGACTTACGACCT -> CCTCTCTGACTTACGACCTA
ACCTGGCAAGAGCGGTATCC -> CCTGGCAAGAGCGGTATCCG
ACGACCTAGCGACGTCTTGC -> CGACCTAGCGACGTCTTGCC
ACGCAAGCTTCCAGCTGCAG -> CGCAAGCTTCCAGCTGCAGC
ACGCATTCGAACTTTGGACC -> CGCATTCGAACTTTGGACCC
ACGCCCCCAATGTCATGGAT -> CGCCCCCAATGTCATGGATT
ACGCTGGGAAGAAAAGCTGA -> CGCTGGGAAGAAAAGCTGAA
ACGCTGTATGCTGCAATTGA -> CGCTGTATGCTGCAATTGAG
ACGGCGGCATGGATCTCATT -> CGGCGGCATGGATCTCATTG
ACGGCTCGCGCGGTCCTGCC -> CGGCTCGCGCGGTCCTGCCA
ACGGTAACACTATTTGTGGC -> CGGTAACACTATTTGTGGCC
ACGTACGGCTCGCGCGGTCC -> CGTACGGCTCGCGCGGTCCT
ACGTCATCGCCAGGTCAAGA -> CGTCATCGCCAGGTCAAGAT
ACGTCTTGCCCATTGGTGAG -> CGTCTTGCCCATTGGTGAGG
ACTAGGCACAGCGGTAACAT -> CTAGGCACAGCGGTAACATA
ACTAGTAGAGGTAGGGACTA -> CTAGTAGAGGTAGGGACTAT
ACTATGGTCTCACCTCTCTG -> CTATGGTCTCACCTCTCTGA
ACTATTTGTGGCCTACAAAC -> CTATTTGTGGCCTACAAACC
ACTCATAAGGGATATGACTA -> CTCATAAGGGATATGACTAG
ACTCCAAGATCAGTCGGCAA -> CTCCAAGATCAGTCGGCAAG
ACTCGACTCCAAGATCAGTC -> CTCGACTCCAAGATCAGTCG
ACTCGTATATATGAACAGCT -> CTCGTATATATGAACAGCTG
ACTCGTTTACTCGACTCCAA -> CTCGTTTACTCGACTCCAAG
ACTCTTGGTCTACTGCTGAG -> CTCTTGGTCTACTGCTGAGA
ACTGAATGCCCTTACCCTAA -> CTGAATGCCCTTACCCTAAT
ACTGCTAACCGAGAGGTTAT -> CTGCTAACCGAGAGGTTATT
ACTGCTGAGAGAGGAGGACA -> CTGCTGAGAGAGGAGGACAA
ACTGTAGGAGTTAACTTCAT -> CTGTAGGAGTTAACTTCATG
ACTTAAGCGTTCGCTGACTG -> CTTAAGCGTTCGCTGACTGA
ACTTAAGTCCTCGTGGCGTC -> CTTAAGTCCTCGTGGCGTCT
ACTTACCTAGGAGGGGCGCC -> CTTACCTAGGAGGGGCGCCC
ACTTACGACCTAGCGACGTC -> CTTACGACCTAGCGACGTCT
ACTTACTCATAAGGGATATG -> CTTACTCATAAGGGATATGA
ACTTCATGAATGTGACGCTG -> CTTCATGAATGTGACGCTGG
ACTTCTTCCGGAGTTAGCGA -> CTTCTTCCGGAGTTAGCGAA
ACTTGAAGTGCCTCTACTTA -> CTTGAAGTGCCTCTACTTAC
ACTTTGGACCCAGTAACACC -> CTTTGGACCCAGTAACACCA
AGAAAAGCTGAAAATACAGA -> GAAAAGCTGAAAATACAGAC
AGAACATAACGTACGGCTCG -> GAACATAACGTACGGCTCGC
AGAATAGTGGCGGCAAACTG -> GAATAGTGGCGGCAAACTGC
AGACATGACTTACCTAGGAG -> GACATGACTTACCTAGGAGG
AGACTAGGCACAGCGGTAAC -> GACTAGGCACAGCGGTAACA
AGACTTAAGCGTTCGCTGAC -> GACTTAAGCGTTCGCTGACT
AGAGAGGAGGACAAGTTAAA -> GAGAGGAGGACAAGTTAAAT
AGAGCACTTAAGTCCTCGTG -> GAGCACTTAAGTCCTCGTGG
AGAGCGGTATCCGGAGCTGA -> GAGCGGTATCCGGAGCTGAC
AGAGGAGGACAAGTTAAATC -> GAGGAGGACAAGTTAAATCA
AGAGGTAGGGACTATGGTCT -> GAGGTAGGGACTATGGTCTC
AGAGGTTATTCTAAGATGCC -> GAGGTTATTCTAAGATGCCT
AGATAGGCGCAAAATCTCGA -> GATAGGCGCAAAATCTCGAT
AGATCAGTCGGCAAGTCTTC -> GATCAGTCGGCAAGTCTTCG
AGATGCCTGAATTTCGCCCC -> GATGCCTGAATTTCGCCCCT
AGATTGGGCCAGCGAACGGC -> GATTGGGCCAGCGAACGGCG
AGCACTTAAGTCCTCGTGGC -> GCACTTAAGTCCTCGTGGCG
AGCCTGACGCATTCGAACTT -> GCCTGACGCATTCGAACTTT
AGCGAACCACAGAGCACTTA -> GCGAACCACAGAGCACTTAA
AGCGAACGGCGGCATGGATC -> GCGAACGGCGGCATGGATCT
AGCGACAATATGACGCAAGC -> GCGACAATATGACGCAAGCT
AGCGACGTCTTGCCCATTGG -> GCGACGTCTTGCCCATTGGT
AGCGGTAACATAACGCTGTA -> GCGGTAACATAACGCTGTAT
AGCGGTATCCGGAGCTGACC -> GCGGTATCCGGAGCTGACCA
AGCGTTCGCTGACTGAATGC -> GCGTTCGCTGACTGAATGCC
AGCTCGACATCGCCAGATTG -> GCTCGACATCGCCAGATTGG
AGCTGAAAATACAGACATGA -> GCTGAAAATACAGACATGAC
AGCTGACCACCCATGCACCC -> GCTGACCACCCATGCACCCA
AGCTGCAGCTCGACATCGCC -> GCTGCAGCTCGACATCGCCA
AGCTGGGACATGATCCCCGT -> GCTGGGACATGATCCCCGTA
AGCTTCCAGCTGCAGCTCGA -> GCTTCCAGCTGCAGCTCGAC
AGGACAAGTTAAATCAAGTA -> GGACAAGTTAAATCAAGTAG
AGGAGGACAAGTTAAATCAA -> GGAGGACAAGTTAAATCAAG
AGGAGGGGCGCCCCGGCTAA -> GGAGGGGCGCCCCGGCTAAC
AGGAGTTAACTTCATGAATG -> GGAGTTAACTTCATGAATGT
AGGCACAGCGGTAACATAAC -> GGCACAGCGGTAACATAACG
AGGCGCAAAATCTCGATGCA -> GGCGCAAAATCTCGATGCAA
AGGGACTATGGTCTCACCTC -> GGGACTATGGTCTCACCTCT
AGGGAGTATGCGGATAGACT -> GGGAGTATGCGGATAGACTA
AGGGATATGACTAGTAGAGG -> GGGATATGACTAGTAGAGGT
AGGGGCGCCCCGGCTAACGC -> GGGGCGCCCCGGCTAACGCC
AGGTAGGGACTATGGTCTCA -> GGTAGGGACTATGGTCTCAC
AGGTCAAGATAGGCGCAAAA -> GGTCAAGATAGGCGCAAAAT
AGGTCAGAACATAACGTACG -> GGTCAGAACATAACGTACGG
AGGTTATTCTAAGATGCCTG -> GGTTATTCTAAGATGCCTGA
AGTAACACCAGACTTAAGCG -> GTAACACCAGACTTAAGCGT
AGTAGAGGTAGGGACTATGG -> GTAGAGGTAGGGACTATGGT
AGTAGTCATTGAGGGAGTAT -> GTAGTCATTGAGGGAGTATG
AGTATGCGGATAGACTAGGC -> GTATGCGGATAGACTAGGCA
AGTATTGCTACTTGAAGTGC -> GTATTGCTACTTGAAGTGCC
AGTCATTGAGGGAGTATGCG -> GTCATTGAGGGAGTATGCGG
AGTCCCATTTTGCACCCTAC -> GTCCCATTTTGCACCCTACT
AGTCCTCGTGGCGTCTTTCG -> GTCCTCGTGGCGTCTTTCGT
AGTCGGCAAGTCTTCGATCG -> GTCGGCAAGTCTTCGATCGG
AGTCTTCGATCGGGTAAGGT -> GTCTTCGATCGGGTAAGGTG
AGTGCCTCTACTTACTCATA -> GTGCCTCTACTTACTCATAA
AGTGGCGGCAAACTGCTAAC -> GTGGCGGCAAACTGCTAACC
AGTGTTGCACCATTCTACTG -> GTGTTGCACCATTCTACTGT
AGTTAAATCAAGTAGTCATT -> GTTAAATCAAGTAGTCATTG
AGTTAACTTCATGAATGTGA -> GTTAACTTCATGAATGTGAC
AGTTAGCGAACCACAGAGCA -> GTTAGCGAACCACAGAGCAC
ATAACAGTGTTGCACCATTC -> TAACAGTGTTGCACCATTCT
ATAACGCTGTATGCTGCAAT -> TAACGCTGTATGCTGCAATT
ATAACGTACGGCTCGCGCGG -> TAACGTACGGCTCGCGCGGT
ATAAGGGATATGACTAGTAG -> TAAGGGATATGACTAGTAGA
ATACAGACATGACTTACCTA -> TACAGACATGACTTACCTAG
ATACGGTAACACTATTTGTG -> TACGGTAACACTATTTGTGG
ATAGACTAGGCACAGCGGTA -> TAGACTAGGCACAGCGGTAA
ATAGGCGCAAAATCTCGATG -> TAGGCGCAAAATCTCGATGC
ATAGTGGCGGCAAACTGCTA -> TAGTGGCGGCAAACTGCTAA
ATATATGAACAGCTGGGACA -> TATATGAACAGCTGGGACAT
ATATGAACAGCTGGGACATG -> TATGAACAGCTGGGACATGA
ATATGACGCAAGCTTCCAGC -> TATGACGCAAGCTTCCAGCT
ATATGACTAGTAGAGGTAGG -> TATGACTAGTAGAGGTAGGG
ATATGTCAAAACCCGGAAAC -> TATGTCAAAACCCGGAAACT
ATCAAGTAGTCATTGAGGGA -> TCAAGTAGTCATTGAGGGAG
ATCAGTATTGCTACTTGAAG -> TCAGTATTGCTACTTGAAGT
ATCAGTCGGCAAGTCTTCGA -> TCAGTCGGCAAGTCTTCGAT
ATCATGACAAACATAACAGT -> TCATGACAAACATAACAGTG
ATCCCCGTATACGGTAACAC -> TCCCCGTATACGGTAACACT
ATCCGGAGCTGACCACCCAT -> TCCGGAGCTGACCACCCATG
ATCCGGGAGTCCCATTTTGC -> TCCGGGAGTCCCATTTTGCA
ATCGCCAGATTGGGCCAGCG -> TCGCCAGATTGGGCCAGCGA
ATCGCCAGGTCAAGATAGGC -> TCGCCAGGTCAAGATAGGCG
ATCGTTGCTTTAAATGACTT -> TCGTTGCTTTAAATGACTTC
ATCTCATTGGTTTTCGCTGG -> TCTCATTGGTTTTCGCTGGC
ATCTCGATGCAATGGAGAAT -> TCTCGATGCAATGGAGAATA
ATGAACAGCTGGGACATGAT -> TGAACAGCTGGGACATGATC
ATGAATGTGACGCTGGGAAG -> TGAATGTGACGCTGGGAAGA
ATGACAAACATAACAGTGTT -> TGACAAACATAACAGTGTTG
ATGACGCAAGCTTCCAGCTG -> TGACGCAAGCTTCCAGCTGC
ATGACTAGTAGAGGTAGGGA -> TGACTAGTAGAGGTAGGGAC
ATGACTTACCTAGGAGGGGC -> TGACTTACCTAGGAGGGGCG
ATGACTTCTTCCGGAGTTAG -> TGACTTCTTCCGGAGTTAGC
ATGATCCCCGTATACGGTAA -> TGATCCCCGTATACGGTAAC
ATGCAATGGAGAATAGTGGC -> TGCAATGGAGAATAGTGGCG
ATGCACCCATCAGTATTGCT -> TGCACCCATCAGTATTGCTA
ATGCACCCTGGATCATGACA -> TGCACCCTGGATCATGACAA
ATGCCCTTACCCTAATGCAC -> TGCCCTTACCCTAATGCACC
ATGCCTGAATTTCGCCCCTC -> TGCCTGAATTTCGCCCCTCG
ATGCGGATAGACTAGGCACA -> TGCGGATAGACTAGGCACAG
ATGCTGCAATTGAGCCTGAC -> TGCTGCAATTGAGCCTGACG
ATGGAGAATAGTGGCGGCAA -> TGGAGAATAGTGGCGGCAAA
ATGGATCTCATTGGTTTTCG -> TGGATCTCATTGGTTTTCGC
ATGGATTCTTATATGTCAAA -> TGGATTCTTATATGTCAAAA
ATGGTCTCACCTCTCTGACT -> TGGTCTCACCTCTCTGACTT
ATGTCAAAACCCGGAAACTC -> TGTCAAAACCCGGAAACTCG
ATGTCATGGATTCTTATATG -> TGTCATGGATTCTTATATGT
ATGTGACGCTGGGAAGAAAA -> TGTGACGCTGGGAAGAAAAG
ATTCGAACTTTGGACCCAGT -> TTCGAACTTTGGACCCAGTA
ATTCTAAGATGCCTGAATTT -> TTCTAAGATGCCTGAATTTC
ATTCTACTGTAGGAGTTAAC -> TTCTACTGTAGGAGTTAACT
ATTCTTATATGTCAAAACCC -> TTCTTATATGTCAAAACCCG
ATTGAGCCTGACGCATTCGA -> TTGAGCCTGACGCATTCGAA
ATTGAGGGAGTATGCGGATA -> TTGAGGGAGTATGCGGATAG
ATTGCTACTTGAAGTGCCTC -> TTGCTACTTGAAGTGCCTCT
ATTGGGCCAGCGAACGGCGG -> TTGGGCCAGCGAACGGCGGC
ATTGGTGAGGTCAGAACATA -> TTGGTGAGGTCAGAACATAA
ATTGGTTTTCGCTGGCGCCA -> TTGGTTTTCGCTGGCGCCAC
ATTGTGCTACCTGGCAAGAG -> TTGTGCTACCTGGCAAGAGC
ATTTCGCCCCTCGCCTGATT -> TTTCGCCCCTCGCCTGATTG
ATTTGTGGCCTACAAACCCG -> TTTGTGGCCTACAAACCCGA
ATTTTCATCGTTGCTTTAAA -> TTTTCATCGTTGCTTTAAAT
ATTTTGCACCCTACTCTTGG -> TTTTGCACCCTACTCTTGGT
CAAAACCCGGAAACTCGTAT -> AAAACCCGGAAACTCGTATA
CAAAATCTCGATGCAATGGA -> AAAATCTCGATGCAATGGAG
CAAACATAACAGTGTTGCAC -> AAACATAACAGTGTTGCACC
CAAACCCGACGTCATCGCCA -> AAACCCGACGTCATCGCCAG
CAAACTGCTAACCGAGAGGT -> AAACTGCTAACCGAGAGGTT
CAAGAGCGGTATCCGGAGCT -> AAGAGCGGTATCCGGAGCTG
CAAGATAGGCGCAAAATCTC -> AAGATAGGCGCAAAATCTCG
CAAGATCAGTCGGCAAGTCT -> AAGATCAGTCGGCAAGTCTT
CAAGCTTCCAGCTGCAGCTC -> AAGCTTCCAGCTGCAGCTCG
CAAGTAGTCATTGAGGGAGT -> AAGTAGTCATTGAGGGAGTA
CAAGTCTTCGATCGGGTAAG -> AAGTCTTCGATCGGGTAAGG
CAAGTTAAATCAAGTAGTCA -> AAGTTAAATCAAGTAGTCAT
CAATATGACGCAAGCTTCCA -> AATATGACGCAAGCTTCCAG
CAATGGAGAATAGTGGCGGC -> AATGGAGAATAGTGGCGGCA
CAATGTCATGGATTCTTATA -> AATGTCATGGATTCTTATAT
CAATTGAGCCTGACGCATTC -> AATTGAGCCTGACGCATTCG
CACAGAGCACTTAAGTCCTC -> ACAGAGCACTTAAGTCCTCG
CACAGCGGTAACATAACGCT -> ACAGCGGTAACATAACGCTG
CACCAGACTTAAGCGTTCGC -> ACCAGACTTAAGCGTTCGCT
CACCATTCTACTGTAGGAGT -> ACCATTCTACTGTAGGAGTT
CACCCATCAGTATTGCTACT -> ACCCATCAGTATTGCTACTT
CACCCATGCACCCATCAGTA -> ACCCATGCACCCATCAGTAT
CACCCTACTCTTGGTCTACT -> ACCCTACTCTTGGTCTACTG
CACCCTGGATCATGACAAAC -> ACCCTGGATCATGACAAACA
CACCTCTCTGACTTACGACC -> ACCTCTCTGACTTACGACCT
CACTATTTGTGGCCTACAAA -> ACTATTTGTGGCCTACAAAC
CACTCGTTTACTCGACTCCA -> ACTCGTTTACTCGACTCCAA
CACTTAAGTCCTCGTGGCGT -> ACTTAAGTCCTCGTGGCGTC
CAGAACATAACGTACGGCTC -> AGAACATAACGTACGGCTCG
CAGACATGACTTACCTAGGA -> AGACATGACTTACCTAGGAG
CAGACTTAAGCGTTCGCTGA -> AGACTTAAGCGTTCGCTGAC
CAGAGCACTTAAGTCCTCGT -> AGAGCACTTAAGTCCTCGTG
CAGATTGGGCCAGCGAACGG -> AGATTGGGCCAGCGAACGGC
CAGCGAACGGCGGCATGGAT -> AGCGAACGGCGGCATGGATC
CAGCGACAATATGACGCAAG -> AGCGACAATATGACGCAAGC
CAGCGGTAACATAACGCTGT -> AGCGGTAACATAACGCTGTA
CAGCTCGACATCGCCAGATT -> AGCTCGACATCGCCAGATTG
CAGCTGCAGCTCGACATCGC -> AGCTGCAGCTCGACATCGCC
CAGCTGGGACATGATCCCCG -> AGCTGGGACATGATCCCCGT
CAGGTCAAGATAGGCGCAAA -> AGGTCAAGATAGGCGCAAAA
CAGTAACACCAGACTTAAGC -> AGTAACACCAGACTTAAGCG
CAGTATTGCTACTTGAAGTG -> AGTATTGCTACTTGAAGTGC
CAGTCGGCAAGTCTTCGATC -> AGTCGGCAAGTCTTCGATCG
CAGTGTTGCACCATTCTACT -> AGTGTTGCACCATTCTACTG
CATAACAGTGTTGCACCATT -> ATAACAGTGTTGCACCATTC
CATAACGCTGTATGCTGCAA -> ATAACGCTGTATGCTGCAAT
CATAACGTACGGCTCGCGCG -> ATAACGTACGGCTCGCGCGG
CATAAGGGATATGACTAGTA -> ATAAGGGATATGACTAGTAG
CATCAGTATTGCTACTTGAA -> ATCAGTATTGCTACTTGAAG
CATCGCCAGATTGGGCCAGC -> ATCGCCAGATTGGGCCAGCG
CATCGCCAGGTCAAGATAGG -> ATCGCCAGGTCAAGATAGGC
CATCGTTGCTTTAAATGACT -> ATCGTTGCTTTAAATGACTT
CATGAATGTGACGCTGGGAA -> ATGAATGTGACGCTGGGAAG
CATGACAAACATAACAGTGT -> ATGACAAACATAACAGTGTT
CATGACTTACCTAGGAGGGG -> ATGACTTACCTAGGAGGGGC
CATGATCCCCGTATACGGTA -> ATGATCCCCGTATACGGTAA
CATGCACCCATCAGTATTGC -> ATGCACCCATCAGTATTGCT
CATGGATCTCATTGGTTTTC -> ATGGATCTCATTGGTTTTCG
CATGGATTCTTATATGTCAA -> ATGGATTCTTATATGTCAAA
CATTCGAACTTTGGACCCAG -> ATTCGAACTTTGGACCCAGT
CATTCTACTGTAGGAGTTAA -> ATTCTACTGTAGGAGTTAAC
CATTGAGGGAGTATGCGGAT -> ATTGAGGGAGTATGCGGATA
CATTGGTGAGGTCAGAACAT -> ATTGGTGAGGTCAGAACATA
CATTGGTTTTCGCTGGCGCC -> ATTGGTTTTCGCTGGCGCCA
CATTTTGCACCCTACTCTTG -> ATTTTGCACCCTACTCTTGG
CCAAGATCAGTCGGCAAGTC -> CAAGATCAGTCGGCAAGTCT
CCAATGTCATGGATTCTTAT -> CAATGTCATGGATTCTTATA
CCACAGAGCACTTAAGTCCT -> CACAGAGCACTTAAGTCCTC
CCACCCATGCACCCATCAGT -> CACCCATGCACCCATCAGTA
CCACTCGTTTACTCGACTCC -> CACTCGTTTACTCGACTCCA
CCAGACTTAAGCGTTCGCTG -> CAGACTTAAGCGTTCGCTGA
CCAGATTGGGCCAGCGAACG -> CAGATTGGGCCAGCGAACGG
CCAGCGAACGGCGGCATGGA -> CAGCGAACGGCGGCATGGAT
CCAGCGACAATATGACGCAA -> CAGCGACAATATGACGCAAG
CCAGCTGCAGCTCGACATCG -> CAGCTGCAGCTCGACATCGC
CCAGGTCAAGATAGGCGCAA -> CAGGTCAAGATAGGCGCAAA
CCAGTAACACCAGACTTAAG -> CAGTAACACCAGACTTAAGC
CCATCAGTATTGCTACTTGA -> CATCAGTATTGCTACTTGAA
CCATGCACCCATCAGTATTG -> CATGCACCCATCAGTATTGC
CCATTCTACTGTAGGAGTTA -> CATTCTACTGTAGGAGTTAA
CCATTGGTGAGGTCAGAACA -> CATTGGTGAGGTCAGAACAT
CCATTTTGCACCCTACTCTT -> CATTTTGCACCCTACTCTTG
CCCAATGTCATGGATTCTTA -> CCAATGTCATGGATTCTTAT
CCCAGTAACACCAGACTTAA -> CCAGTAACACCAGACTTAAG
CCCATCAGTATTGCTACTTG -> CCATCAGTATTGCTACTTGA
CCCATGCACCCATCAGTATT -> CCATGCACCCATCAGTATTG
CCCATTGGTGAGGTCAGAAC -> CCATTGGTGAGGTCAGAACA
CCCATTTTGCACCCTACTCT -> CCATTTTGCACCCTACTCTT
CCCCAATGTCATGGATTCTT -> CCCAATGTCATGGATTCTTA
CCCCCAATGTCATGGATTCT -> CCCCAATGTCATGGATTCTT
CCCCGGCTAACGCCCCCAAT -> CCCGGCTAACGCCCCCAATG
CCCCGTATACGGTAACACTA -> CCCGTATACGGTAACACTAT
CCCCTCGCCTGATTGTGCTA -> CCCTCGCCTGATTGTGCTAC
CCCGACGTCATCGCCAGGTC -> CCGACGTCATCGCCAGGTCA
CCCGGAAACTCGTATATATG -> CCGGAAACTCGTATATATGA
CCCGGCTAACGCCCCCAATG -> CCGGCTAACGCCCCCAATGT
CCCGTATACGGTAACACTAT -> CCGTATACGGTAACACTATT
CCCTAATGCACCCTGGATCA -> CCTAATGCACCCTGGATCAT
CCCTACTCTTGGTCTACTGC -> CCTACTCTTGGTCTACTGCT
CCCTCGCCTGATTGTGCTAC -> CCTCGCCTGATTGTGCTACC
CCCTGGATCATGACAAACAT -> CCTGGATCATGACAAACATA
CCCTTACCCTAATGCACCCT -> CCTTACCCTAATGCACCCTG
CCGACGTCATCGCCAGGTCA -> CGACGTCATCGCCAGGTCAA
CCGAGAGGTTATTCTAAGAT -> CGAGAGGTTATTCTAAGATG
CCGGAAACTCGTATATATGA -> CGGAAACTCGTATATATGAA
CCGGAGCTGACCACCCATGC -> CGGAGCTGACCACCCATGCA
CCGGAGTTAGCGAACCACAG -> CGGAGTTAGCGAACCACAGA
CCGGCTAACGCCCCCAATGT -> CGGCTAACGCCCCCAATGTC
CCGGGAGTCCCATTTTGCAC -> CGGGAGTCCCATTTTGCACC
CCGTATACGGTAACACTATT -> CGTATACGGTAACACTATTT
CCTAATGCACCCTGGATCAT -> CTAATGCACCCTGGATCATG
CCTACAAACCCGACGTCATC -> CTACAAACCCGACGTCATCG
CCTACTCTTGGTCTACTGCT -> CTACTCTTGGTCTACTGCTG
CCTAGCGACGTCTTGCCCAT -> CTAGCGACGTCTTGCCCATT
CCTAGGAGGGGCGCCCCGGC -> CTAGGAGGGGCGCCCCGGCT
CCTCGCCTGATTGTGCTACC -> CTCGCCTGATTGTGCTACCT
CCTCGTGGCGTCTTTCGTTG -> CTCGTGGCGTCTTTCGTTGG
CCTCTACTTACTCATAAGGG -> CTCTACTTACTCATAAGGGA
CCTCTCTGACTTACGACCTA -> CTCTCTGACTTACGACCTAG
CCTGAATTTCGCCCCTCGCC -> CTGAATTTCGCCCCTCGCCT
CCTGACGCATTCGAACTTTG -> CTGACGCATTCGAACTTTGG
CCTGATTGTGCTACCTGGCA -> CTGATTGTGCTACCTGGCAA
CCTGCCAGCGACAATATGAC -> CTGCCAGCGACAATATGACG
CCTGGATCATGACAAACATA -> CTGGATCATGACAAACATAA
CCTGGCAAGAGCGGTATCCG -> CTGGCAAGAGCGGTATCCGG
CCTTACCCTAATGCACCCTG -> CTTACCCTAATGCACCCTGG
CGAACCACAGAGCACTTAAG -> GAACCACAGAGCACTTAAGT
CGAACGGCGGCATGGATCTC -> GAACGGCGGCATGGATCTCA
CGAACTTTGGACCCAGTAAC -> GAACTTTGGACCCAGTAACA
CGAATTTTCATCGTTGCTTT -> GAATTTTCATCGTTGCTTTA
CGACAATATGACGCAAGCTT -> GACAATATGACGCAAGCTTC
CGACATCGCCAGATTGGGCC -> GACATCGCCAGATTGGGCCA
CGACCTAGCGACGTCTTGCC -> GACCTAGCGACGTCTTGCCC
CGACGTCATCGCCAGGTCAA -> GACGTCATCGCCAGGTCAAG
CGACGTCTTGCCCATTGGTG -> GACGTCTTGCCCATTGGTGA
CGACTCCAAGATCAGTCGGC -> GACTCCAAGATCAGTCGGCA
CGAGAGGTTATTCTAAGATG -> GAGAGGTTATTCTAAGATGC
CGATGCAATGGAGAATAGTG -> GATGCAATGGAGAATAGTGG
CGCAAAATCTCGATGCAATG -> GCAAAATCTCGATGCAATGG
CGCAAGCTTCCAGCTGCAGC -> GCAAGCTTCCAGCTGCAGCT
CGCATTCGAACTTTGGACCC -> GCATTCGAACTTTGGACCCA
CGCCACTCGTTTACTCGACT -> GCCACTCGTTTACTCGACTC
CGCCAGATTGGGCCAGCGAA -> GCCAGATTGGGCCAGCGAAC
CGCCAGGTCAAGATAGGCGC -> GCCAGGTCAAGATAGGCGCA
CGCCCCCAATGTCATGGATT -> GCCCCCAATGTCATGGATTC
CGCCCCGGCTAACGCCCCCA -> GCCCCGGCTAACGCCCCCAA
CGCCCCTCGCCTGATTGTGC -> GCCCCTCGCCTGATTGTGCT
CGCCTGATTGTGCTACCTGG -> GCCTGATTGTGCTACCTGGC
CGCGCGGTCCTGCCAGCGAC -> GCGCGGTCCTGCCAGCGACA
CGCGGTCCTGCCAGCGACAA -> GCGGTCCTGCCAGCGACAAT
CGCTGACTGAATGCCCTTAC -> GCTGACTGAATGCCCTTACC
CGCTGGCGCCACTCGTTTAC -> GCTGGCGCCACTCGTTTACT
CGCTGGGAAGAAAAGCTGAA -> GCTGGGAAGAAAAGCTGAAA
CGCTGTATGCTGCAATTGAG -> GCTGTATGCTGCAATTGAGC
CGGAAACTCGTATATATGAA -> GGAAACTCGTATATATGAAC
CGGAGCTGACCACCCATGCA -> GGAGCTGACCACCCATGCAC
CGGAGTTAGCGAACCACAGA -> GGAGTTAGCGAACCACAGAG
CGGATAGACTAGGCACAGCG -> GGATAGACTAGGCACAGCGG
CGGCAAACTGCTAACCGAGA -> GGCAAACTGCTAACCGAGAG
CGGCAAGTCTTCGATCGGGT -> GGCAAGTCTTCGATCGGGTA
CGGCATGGATCTCATTGGTT -> GGCATGGATCTCATTGGTTT
CGGCGGCATGGATCTCATTG -> GGCGGCATGGATCTCATTGG
CGGCTAACGCCCCCAATGTC -> GGCTAACGCCCCCAATGTCA
CGGCTCGCGCGGTCCTGCCA -> GGCTCGCGCGGTCCTGCCAG
CGGGAGTCCCATTTTGCACC -> GGGAGTCCCATTTTGCACCC
CGGTAACACTATTTGTGGCC -> GGTAACACTATTTGTGGCCT
CGGTAACATAACGCTGTATG -> GGTAACATAACGCTGTATGC
CGGTATCCGGAGCTGACCAC -> GGTATCCGGAGCTGACCACC
CGGTCCTGCCAGCGACAATA -> GGTCCTGCCAGCGACAATAT
CGTACGGCTCGCGCGGTCCT -> GTACGGCTCGCGCGGTCCTG
CGTATACGGTAACACTATTT -> GTATACGGTAACACTATTTG
CGTATATATGAACAGCTGGG -> GTATATATGAACAGCTGGGA
CGTCATCGCCAGGTCAAGAT -> GTCATCGCCAGGTCAAGATA
CGTCTTGCCCATTGGTGAGG -> GTCTTGCCCATTGGTGAGGT
CGTCTTTCGTTGGGTAATCC -> GTCTTTCGTTGGGTAATCCG
CGTGGCGTCTTTCGTTGGGT -> GTGGCGTCTTTCGTTGGGTA
CGTTCGCTGACTGAATGCCC -> GTTCGCTGACTGAATGCCCT
CGTTGCTTTAAATGACTTCT -> GTTGCTTTAAATGACTTCTT
CGTTGGGTAATCCGGGAGTC -> GTTGGGTAATCCGGGAGTCC
CGTTTACTCGACTCCAAGAT -> GTTTACTCGACTCCAAGATC
CTAACCGAGAGGTTATTCTA -> TAACCGAGAGGTTATTCTAA
CTAACGCCCCCAATGTCATG -> TAACGCCCCCAATGTCATGG
CTAAGATGCCTGAATTTCGC -> TAAGATGCCTGAATTTCGCC
CTAATGCACCCTGGATCATG -> TAATGCACCCTGGATCATGA
CTACAAACCCGACGTCATCG -> TACAAACCCGACGTCATCGC
CTACCTGGCAAGAGCGGTAT -> TACCTGGCAAGAGCGGTATC
CTACTCTTGGTCTACTGCTG -> TACTCTTGGTCTACTGCTGA
CTACTGCTGAGAGAGGAGGA -> TACTGCTGAGAGAGGAGGAC
CTACTGTAGGAGTTAACTTC -> TACTGTAGGAGTTAACTTCA
CTACTTACTCATAAGGGATA -> TACTTACTCATAAGGGATAT
CTACTTGAAGTGCCTCTACT -> TACTTGAAGTGCCTCTACTT
CTAGCGACGTCTTGCCCATT -> TAGCGACGTCTTGCCCATTG
CTAGGAGGGGCGCCCCGGCT -> TAGGAGGGGCGCCCCGGCTA
CTAGGCACAGCGGTAACATA -> TAGGCACAGCGGTAACATAA
CTAGTAGAGGTAGGGACTAT -> TAGTAGAGGTAGGGACTATG
CTATGGTCTCACCTCTCTGA -> TATGGTCTCACCTCTCTGAC
CTATTTGTGGCCTACAAACC -> TATTTGTGGCCTACAAACCC
CTCACCTCTCTGACTTACGA -> TCACCTCTCTGACTTACGAC
CTCATAAGGGATATGACTAG -> TCATAAGGGATATGACTAGT
CTCATTGGTTTTCGCTGGCG -> TCATTGGTTTTCGCTGGCGC
CTCCAAGATCAGTCGGCAAG -> TCCAAGATCAGTCGGCAAGT
CTCGACATCGCCAGATTGGG -> TCGACATCGCCAGATTGGGC
CTCGACTCCAAGATCAGTCG -> TCGACTCCAAGATCAGTCGG
CTCGATGCAATGGAGAATAG -> TCGATGCAATGGAGAATAGT
CTCGCCTGATTGTGCTACCT -> TCGCCTGATTGTGCTACCTG
CTCGCGCGGTCCTGCCAGCG -> TCGCGCGGTCCTGCCAGCGA
CTCGTATATATGAACAGCTG -> TCGTATATATGAACAGCTGG
CTCGTGGCGTCTTTCGTTGG -> TCGTGGCGTCTTTCGTTGGG
CTCGTTTACTCGACTCCAAG -> TCGTTTACTCGACTCCAAGA
CTCTACTTACTCATAAGGGA -> TCTACTTACTCATAAGGGAT
CTCTCTGACTTACGACCTAG -> TCTCTGACTTACGACCTAGC
CTCTGACTTACGACCTAGCG -> TCTGACTTACGACCTAGCGA
CTCTTGGTCTACTGCTGAGA -> TCTTGGTCTACTGCTGAGAG
CTGAAAATACAGACATGACT -> TGAAAATACAGACATGACTT
CTGAATGCCCTTACCCTAAT -> TGAATGCCCTTACCCTAATG
CTGAATTTCGCCCCTCGCCT -> TGAATTTCGCCCCTCGCCTG
CTGACCACCCATGCACCCAT -> TGACCACCCATGCACCCATC
CTGACGCATTCGAACTTTGG -> TGACGCATTCGAACTTTGGA
CTGACTGAATGCCCTTACCC -> TGACTGAATGCCCTTACCCT
CTGACTTACGACCTAGCGAC -> TGACTTACGACCTAGCGACG
CTGAGAGAGGAGGACAAGTT -> TGAGAGAGGAGGACAAGTTA
CTGATTGTGCTACCTGGCAA -> TGATTGTGCTACCTGGCAAG
CTGCAATTGAGCCTGACGCA -> TGCAATTGAGCCTGACGCAT
CTGCAGCTCGACATCGCCAG -> TGCAGCTCGACATCGCCAGA
CTGCCAGCGACAATATGACG -> TGCCAGCGACAATATGACGC
CTGCTAACCGAGAGGTTATT -> TGCTAACCGAGAGGTTATTC
CTGCTGAGAGAGGAGGACAA -> TGCTGAGAGAGGAGGACAAG
CTGGATCATGACAAACATAA -> TGGATCATGACAAACATAAC
CTGGCAAGAGCGGTATCCGG -> TGGCAAGAGCGGTATCCGGA
CTGGCGCCACTCGTTTACTC -> TGGCGCCACTCGTTTACTCG
CTGGGAAGAAAAGCTGAAAA -> TGGGAAGAAAAGCTGAAAAT
CTGGGACATGATCCCCGTAT -> TGGGACATGATCCCCGTATA
CTGTAGGAGTTAACTTCATG -> TGTAGGAGTTAACTTCATGA
CTGTATGCTGCAATTGAGCC -> TGTATGCTGCAATTGAGCCT
CTTAAGCGTTCGCTGACTGA -> TTAAGCGTTCGCTGACTGAA
CTTAAGTCCTCGTGGCGTCT -> TTAAGTCCTCGTGGCGTCTT
CTTACCCTAATGCACCCTGG -> TTACCCTAATGCACCCTGGA
CTTACCTAGGAGGGGCGCCC -> TTACCTAGGAGGGGCGCCCC
CTTACGACCTAGCGACGTCT -> TTACGACCTAGCGACGTCTT
CTTACTCATAAGGGATATGA -> TTACTCATAAGGGATATGAC
CTTATATGTCAAAACCCGGA -> TTATATGTCAAAACCCGGAA
CTTCATGAATGTGACGCTGG -> TTCATGAATGTGACGCTGGG
CTTCCAGCTGCAGCTCGACA -> TTCCAGCTGCAGCTCGACAT
CTTCCGGAGTTAGCGAACCA -> TTCCGGAGTTAGCGAACCAC
CTTCTTCCGGAGTTAGCGAA -> TTCTTCCGGAGTTAGCGAAC
CTTGAAGTGCCTCTACTTAC -> TTGAAGTGCCTCTACTTACT
CTTGCCCATTGGTGAGGTCA -> TTGCCCATTGGTGAGGTCAG
CTTGGTCTACTGCTGAGAGA -> TTGGTCTACTGCTGAGAGAG
CTTTAAATGACTTCTTCCGG -> TTTAAATGACTTCTTCCGGA
CTTTCGTTGGGTAATCCGGG -> TTTCGTTGGGTAATCCGGGA
CTTTGGACCCAGTAACACCA -> TTTGGACCCAGTAACACCAG
GAAAAGCTGAAAATACAGAC -> AAAAGCTGAAAATACAGACA
GAAAATACAGACATGACTTA -> AAAATACAGACATGACTTAC
GAAACTCGTATATATGAACA -> AAACTCGTATATATGAACAG
GAACAGCTGGGACATGATCC -> AACAGCTGGGACATGATCCC
GAACATAACGTACGGCTCGC -> AACATAACGTACGGCTCGCG
GAACCACAGAGCACTTAAGT -> AACCACAGAGCACTTAAGTC
GAACGGCGGCATGGATCTCA -> AACGGCGGCATGGATCTCAT
GAACTTTGGACCCAGTAACA -> AACTTTGGACCCAGTAACAC
GAAGAAAAGCTGAAAATACA -> AAGAAAAGCTGAAAATACAG
GAAGTGCCTCTACTTACTCA -> AAGTGCCTCTACTTACTCAT
GAATAGTGGCGGCAAACTGC -> AATAGTGGCGGCAAACTGCT
GAATGCCCTTACCCTAATGC -> AATGCCCTTACCCTAATGCA
GAATGTGACGCTGGGAAGAA -> AATGTGACGCTGGGAAGAAA
GAATTTCGCCCCTCGCCTGA -> AATTTCGCCCCTCGCCTGAT
GAATTTTCATCGTTGCTTTA -> AATTTTCATCGTTGCTTTAA
GACAAACATAACAGTGTTGC -> ACAAACATAACAGTGTTGCA
GACAAGTTAAATCAAGTAGT -> ACAAGTTAAATCAAGTAGTC
GACAATATGACGCAAGCTTC -> ACAATATGACGCAAGCTTCC
GACATCGCCAGATTGGGCCA -> ACATCGCCAGATTGGGCCAG
GACATGACTTACCTAGGAGG -> ACATGACTTACCTAGGAGGG
GACATGATCCCCGTATACGG -> ACATGATCCCCGTATACGGT
GACCACCCATGCACCCATCA -> ACCACCCATGCACCCATCAG
GACCCAGTAACACCAGACTT -> ACCCAGTAACACCAGACTTA
GACCTAGCGACGTCTTGCCC -> ACCTAGCGACGTCTTGCCCA
GACGCAAGCTTCCAGCTGCA -> ACGCAAGCTTCCAGCTGCAG
GACGCATTCGAACTTTGGAC -> ACGCATTCGAACTTTGGACC
GACGCTGGGAAGAAAAGCTG -> ACGCTGGGAAGAAAAGCTGA
GACGTCATCGCCAGGTCAAG -> ACGTCATCGCCAGGTCAAGA
GACGTCTTGCCCATTGGTGA -> ACGTCTTGCCCATTGGTGAG
GACTAGGCACAGCGGTAACA -> ACTAGGCACAGCGGTAACAT
GACTAGTAGAGGTAGGGACT -> ACTAGTAGAGGTAGGGACTA
GACTATGGTCTCACCTCTCT -> ACTATGGTCTCACCTCTCTG
GACTCCAAGATCAGTCGGCA -> ACTCCAAGATCAGTCGGCAA
GACTGAATGCCCTTACCCTA -> ACTGAATGCCCTTACCCTAA
GACTTAAGCGTTCGCTGACT -> ACTTAAGCGTTCGCTGACTG
GACTTACCTAGGAGGGGCGC -> ACTTACCTAGGAGGGGCGCC
GACTTACGACCTAGCGACGT -> ACTTACGACCTAGCGACGTC
GACTTCTTCCGGAGTTAGCG -> ACTTCTTCCGGAGTTAGCGA
GAGAATAGTGGCGGCAAACT -> AGAATAGTGGCGGCAAACTG
GAGAGAGGAGGACAAGTTAA -> AGAGAGGAGGACAAGTTAAA
GAGAGGAGGACAAGTTAAAT -> AGAGGAGGACAAGTTAAATC
GAGAGGTTATTCTAAGATGC -> AGAGGTTATTCTAAGATGCC
GAGCACTTAAGTCCTCGTGG -> AGCACTTAAGTCCTCGTGGC
GAGCCTGACGCATTCGAACT -> AGCCTGACGCATTCGAACTT
GAGCGGTATCCGGAGCTGAC -> AGCGGTATCCGGAGCTGACC
GAGCTGACCACCCATGCACC -> AGCTGACCACCCATGCACCC
GAGGACAAGTTAAATCAAGT -> AGGACAAGTTAAATCAAGTA
GAGGAGGACAAGTTAAATCA -> AGGAGGACAAGTTAAATCAA
GAGGGAGTATGCGGATAGAC -> AGGGAGTATGCGGATAGACT
GAGGGGCGCCCCGGCTAACG -> AGGGGCGCCCCGGCTAACGC
GAGGTAGGGACTATGGTCTC -> AGGTAGGGACTATGGTCTCA
GAGGTCAGAACATAACGTAC -> AGGTCAGAACATAACGTACG
GAGGTTATTCTAAGATGCCT -> AGGTTATTCTAAGATGCCTG
GAGTATGCGGATAGACTAGG -> AGTATGCGGATAGACTAGGC
GAGTCCCATTTTGCACCCTA -> AGTCCCATTTTGCACCCTAC
GAGTTAACTTCATGAATGTG -> AGTTAACTTCATGAATGTGA
GAGTTAGCGAACCACAGAGC -> AGTTAGCGAACCACAGAGCA
GATAGACTAGGCACAGCGGT -> ATAGACTAGGCACAGCGGTA
GATAGGCGCAAAATCTCGAT -> ATAGGCGCAAAATCTCGATG
GATATGACTAGTAGAGGTAG -> ATATGACTAGTAGAGGTAGG
GATCAGTCGGCAAGTCTTCG -> ATCAGTCGGCAAGTCTTCGA
GATCATGACAAACATAACAG -> ATCATGACAAACATAACAGT
GATCCCCGTATACGGTAACA -> ATCCCCGTATACGGTAACAC
GATCTCATTGGTTTTCGCTG -> ATCTCATTGGTTTTCGCTGG
GATGCAATGGAGAATAGTGG -> ATGCAATGGAGAATAGTGGC
GATGCCTGAATTTCGCCCCT -> ATGCCTGAATTTCGCCCCTC
GATTCTTATATGTCAAAACC -> ATTCTTATATGTCAAAACCC
GATTGGGCCAGCGAACGGCG -> ATTGGGCCAGCGAACGGCGG
GATTGTGCTACCTGGCAAGA -> ATTGTGCTACCTGGCAAGAG
GCAAAATCTCGATGCAATGG -> CAAAATCTCGATGCAATGGA
GCAAACTGCTAACCGAGAGG -> CAAACTGCTAACCGAGAGGT
GCAAGAGCGGTATCCGGAGC -> CAAGAGCGGTATCCGGAGCT
GCAAGCTTCCAGCTGCAGCT -> CAAGCTTCCAGCTGCAGCTC
GCAAGTCTTCGATCGGGTAA -> CAAGTCTTCGATCGGGTAAG
GCAATGGAGAATAGTGGCGG -> CAATGGAGAATAGTGGCGGC
GCAATTGAGCCTGACGCATT -> CAATTGAGCCTGACGCATTC
GCACAGCGGTAACATAACGC -> CACAGCGGTAACATAACGCT
GCACCATTCTACTGTAGGAG -> CACCATTCTACTGTAGGAGT
GCACCCATCAGTATTGCTAC -> CACCCATCAGTATTGCTACT
GCACCCTACTCTTGGTCTAC -> CACCCTACTCTTGGTCTACT
GCACCCTGGATCATGACAAA -> CACCCTGGATCATGACAAAC
GCACTTAAGTCCTCGTGGCG -> CACTTAAGTCCTCGTGGCGT
GCAGCTCGACATCGCCAGAT -> CAGCTCGACATCGCCAGATT
GCATGGATCTCATTGGTTTT -> CATGGATCTCATTGGTTTTC
GCATTCGAACTTTGGACCCA -> CATTCGAACTTTGGACCCAG
GCCACTCGTTTACTCGACTC -> CCACTCGTTTACTCGACTCC
GCCAGATTGGGCCAGCGAAC -> CCAGATTGGGCCAGCGAACG
GCCAGCGAACGGCGGCATGG -> CCAGCGAACGGCGGCATGGA
GCCAGCGACAATATGACGCA -> CCAGCGACAATATGACGCAA
GCCAGGTCAAGATAGGCGCA -> CCAGGTCAAGATAGGCGCAA
GCCCATTGGTGAGGTCAGAA -> CCCATTGGTGAGGTCAGAAC
GCCCCCAATGTCATGGATTC -> CCCCCAATGTCATGGATTCT
GCCCCGGCTAACGCCCCCAA -> CCCCGGCTAACGCCCCCAAT
GCCCCTCGCCTGATTGTGCT -> CCCCTCGCCTGATTGTGCTA
GCCCTTACCCTAATGCACCC -> CCCTTACCCTAATGCACCCT
GCCTACAAACCCGACGTCAT -> CCTACAAACCCGACGTCATC
GCCTCTACTTACTCATAAGG -> CCTCTACTTACTCATAAGGG
GCCTGAATTTCGCCCCTCGC -> CCTGAATTTCGCCCCTCGCC
GCCTGACGCATTCGAACTTT -> CCTGACGCATTCGAACTTTG
GCCTGATTGTGCTACCTGGC -> CCTGATTGTGCTACCTGGCA
GCGAACCACAGAGCACTTAA -> CGAACCACAGAGCACTTAAG
GCGAACGGCGGCATGGATCT -> CGAACGGCGGCATGGATCTC
GCGACAATATGACGCAAGCT -> CGACAATATGACGCAAGCTT
GCGACGTCTTGCCCATTGGT -> CGACGTCTTGCCCATTGGTG
GCGCAAAATCTCGATGCAAT -> CGCAAAATCTCGATGCAATG
GCGCCACTCGTTTACTCGAC -> CGCCACTCGTTTACTCGACT
GCGCCCCGGCTAACGCCCCC -> CGCCCCGGCTAACGCCCCCA
GCGCGGTCCTGCCAGCGACA -> CGCGGTCCTGCCAGCGACAA
GCGGATAGACTAGGCACAGC -> CGGATAGACTAGGCACAGCG
GCGGCAAACTGCTAACCGAG -> CGGCAAACTGCTAACCGAGA
GCGGCATGGATCTCATTGGT -> CGGCATGGATCTCATTGGTT
GCGGTAACATAACGCTGTAT -> CGGTAACATAACGCTGTATG
GCGGTATCCGGAGCTGACCA -> CGGTATCCGGAGCTGACCAC
GCGGTCCTGCCAGCGACAAT -> CGGTCCTGCCAGCGACAATA
GCGTCTTTCGTTGGGTAATC -> CGTCTTTCGTTGGGTAATCC
GCGTTCGCTGACTGAATGCC -> CGTTCGCTGACTGAATGCCC
GCTAACCGAGAGGTTATTCT -> CTAACCGAGAGGTTATTCTA
GCTAACGCCCCCAATGTCAT -> CTAACGCCCCCAATGTCATG
GCTACCTGGCAAGAGCGGTA -> CTACCTGGCAAGAGCGGTAT
GCTACTTGAAGTGCCTCTAC -> CTACTTGAAGTGCCTCTACT
GCTCGACATCGCCAGATTGG -> CTCGACATCGCCAGATTGGG
GCTCGCGCGGTCCTGCCAGC -> CTCGCGCGGTCCTGCCAGCG
GCTGAAAATACAGACATGAC -> CTGAAAATACAGACATGACT
GCTGACCACCCATGCACCCA -> CTGACCACCCATGCACCCAT
GCTGACTGAATGCCCTTACC -> CTGACTGAATGCCCTTACCC
GCTGAGAGAGGAGGACAAGT -> CTGAGAGAGGAGGACAAGTT
GCTGCAATTGAGCCTGACGC -> CTGCAATTGAGCCTGACGCA
GCTGCAGCTCGACATCGCCA -> CTGCAGCTCGACATCGCCAG
GCTGGCGCCACTCGTTTACT -> CTGGCGCCACTCGTTTACTC
GCTGGGAAGAAAAGCTGAAA -> CTGGGAAGAAAAGCTGAAAA
GCTGGGACATGATCCCCGTA -> CTGGGACATGATCCCCGTAT
GCTGTATGCTGCAATTGAGC -> CTGTATGCTGCAATTGAGCC
GCTTCCAGCTGCAGCTCGAC -> CTTCCAGCTGCAGCTCGACA
GCTTTAAATGACTTCTTCCG -> CTTTAAATGACTTCTTCCGG
GGAAACTCGTATATATGAAC -> GAAACTCGTATATATGAACA
GGAAGAAAAGCTGAAAATAC -> GAAGAAAAGCTGAAAATACA
GGACAAGTTAAATCAAGTAG -> GACAAGTTAAATCAAGTAGT
GGACATGATCCCCGTATACG -> GACATGATCCCCGTATACGG
GGACCCAGTAACACCAGACT -> GACCCAGTAACACCAGACTT
GGACTATGGTCTCACCTCTC -> GACTATGGTCTCACCTCTCT
GGAGAATAGTGGCGGCAAAC -> GAGAATAGTGGCGGCAAACT
GGAGCTGACCACCCATGCAC -> GAGCTGACCACCCATGCACC
GGAGGACAAGTTAAATCAAG -> GAGGACAAGTTAAATCAAGT
GGAGGGGCGCCCCGGCTAAC -> GAGGGGCGCCCCGGCTAACG
GGAGTATGCGGATAGACTAG -> GAGTATGCGGATAGACTAGG
GGAGTCCCATTTTGCACCCT -> GAGTCCCATTTTGCACCCTA
GGAGTTAACTTCATGAATGT -> GAGTTAACTTCATGAATGTG
GGAGTTAGCGAACCACAGAG -> GAGTTAGCGAACCACAGAGC
GGATAGACTAGGCACAGCGG -> GATAGACTAGGCACAGCGGT
GGATATGACTAGTAGAGGTA -> GATATGACTAGTAGAGGTAG
GGATCATGACAAACATAACA -> GATCATGACAAACATAACAG
GGATCTCATTGGTTTTCGCT -> GATCTCATTGGTTTTCGCTG
GGATTCTTATATGTCAAAAC -> GATTCTTATATGTCAAAACC
GGCAAACTGCTAACCGAGAG -> GCAAACTGCTAACCGAGAGG
GGCAAGAGCGGTATCCGGAG -> GCAAGAGCGGTATCCGGAGC
GGCAAGTCTTCGATCGGGTA -> GCAAGTCTTCGATCGGGTAA
GGCACAGCGGTAACATAACG -> GCACAGCGGTAACATAACGC
GGCATGGATCTCATTGGTTT -> GCATGGATCTCATTGGTTTT
GGCCAGCGAACGGCGGCATG -> GCCAGCGAACGGCGGCATGG
GGCCTACAAACCCGACGTCA -> GCCTACAAACCCGACGTCAT
GGCGCAAAATCTCGATGCAA -> GCGCAAAATCTCGATGCAAT
GGCGCCACTCGTTTACTCGA -> GCGCCACTCGTTTACTCGAC
GGCGCCCCGGCTAACGCCCC -> GCGCCCCGGCTAACGCCCCC
GGCGGCAAACTGCTAACCGA -> GCGGCAAACTGCTAACCGAG
GGCGGCATGGATCTCATTGG -> GCGGCATGGATCTCATTGGT
GGCGTCTTTCGTTGGGTAAT -> GCGTCTTTCGTTGGGTAATC
GGCTAACGCCCCCAATGTCA -> GCTAACGCCCCCAATGTCAT
GGCTCGCGCGGTCCTGCCAG -> GCTCGCGCGGTCCTGCCAGC
GGGAAGAAAAGCTGAAAATA -> GGAAGAAAAGCTGAAAATAC
GGGACATGATCCCCGTATAC -> GGACATGATCCCCGTATACG
GGGACTATGGTCTCACCTCT -> GGACTATGGTCTCACCTCTC
GGGAGTATGCGGATAGACTA -> GGAGTATGCGGATAGACTAG
GGGAGTCCCATTTTGCACCC -> GGAGTCCCATTTTGCACCCT
GGGATATGACTAGTAGAGGT -> GGATATGACTAGTAGAGGTA
GGGCCAGCGAACGGCGGCAT -> GGCCAGCGAACGGCGGCATG
GGGCGCCCCGGCTAACGCCC -> GGCGCCCCGGCTAACGCCCC
GGGGCGCCCCGGCTAACGCC -> GGGCGCCCCGGCTAACGCCC
GGGTAATCCGGGAGTCCCAT -> GGTAATCCGGGAGTCCCATT
GGTAACACTATTTGTGGCCT -> GTAACACTATTTGTGGCCTA
GGTAACATAACGCTGTATGC -> GTAACATAACGCTGTATGCT
GGTAATCCGGGAGTCCCATT -> GTAATCCGGGAGTCCCATTT
GGTAGGGACTATGGTCTCAC -> GTAGGGACTATGGTCTCACC
GGTATCCGGAGCTGACCACC -> GTATCCGGAGCTGACCACCC
GGTCAAGATAGGCGCAAAAT -> GTCAAGATAGGCGCAAAATC
GGTCAGAACATAACGTACGG -> GTCAGAACATAACGTACGGC
GGTCCTGCCAGCGACAATAT -> GTCCTGCCAGCGACAATATG
GGTCTACTGCTGAGAGAGGA -> GTCTACTGCTGAGAGAGGAG
GGTCTCACCTCTCTGACTTA -> GTCTCACCTCTCTGACTTAC
GGTGAGGTCAGAACATAACG -> GTGAGGTCAGAACATAACGT
GGTTATTCTAAGATGCCTGA -> GTTATTCTAAGATGCCTGAA
GGTTTTCGCTGGCGCCACTC -> GTTTTCGCTGGCGCCACTCG
GTAACACCAGACTTAAGCGT -> TAACACCAGACTTAAGCGTT
GTAACACTATTTGTGGCCTA -> TAACACTATTTGTGGCCTAC
GTAACATAACGCTGTATGCT -> TAACATAACGCTGTATGCTG
GTAATCCGGGAGTCCCATTT -> TAATCCGGGAGTCCCATTTT
GTACGGCTCGCGCGGTCCTG -> TACGGCTCGCGCGGTCCTGC
GTAGAGGTAGGGACTATGGT -> TAGAGGTAGGGACTATGGTC
GTAGGAGTTAACTTCATGAA -> TAGGAGTTAACTTCATGAAT
GTAGGGACTATGGTCTCACC -> TAGGGACTATGGTCTCACCT
GTAGTCATTGAGGGAGTATG -> TAGTCATTGAGGGAGTATGC
GTATACGGTAACACTATTTG -> TATACGGTAACACTATTTGT
GTATATATGAACAGCTGGGA -> TATATATGAACAGCTGGGAC
GTATCCGGAGCTGACCACCC -> TATCCGGAGCTGACCACCCA
GTATGCGGATAGACTAGGCA -> TATGCGGATAGACTAGGCAC
GTATGCTGCAATTGAGCCTG -> TATGCTGCAATTGAGCCTGA
GTATTGCTACTTGAAGTGCC -> TATTGCTACTTGAAGTGCCT
GTCAAAACCCGGAAACTCGT -> TCAAAACCCGGAAACTCGTA
GTCAAGATAGGCGCAAAATC -> TCAAGATAGGCGCAAAATCT
GTCAGAACATAACGTACGGC -> TCAGAACATAACGTACGGCT
GTCATCGCCAGGTCAAGATA -> TCATCGCCAGGTCAAGATAG
GTCATGGATTCTTATATGTC -> TCATGGATTCTTATATGTCA
GTCATTGAGGGAGTATGCGG -> TCATTGAGGGAGTATGCGGA
GTCCCATTTTGCACCCTACT -> TCCCATTTTGCACCCTACTC
GTCCTCGTGGCGTCTTTCGT -> TCCTCGTGGCGTCTTTCGTT
GTCCTGCCAGCGACAATATG -> TCCTGCCAGCGACAATATGA
GTCGGCAAGTCTTCGATCGG -> TCGGCAAGTCTTCGATCGGG
GTCTACTGCTGAGAGAGGAG -> TCTACTGCTGAGAGAGGAGG
GTCTCACCTCTCTGACTTAC -> TCTCACCTCTCTGACTTACG
GTCTTGCCCATTGGTGAGGT -> TCTTGCCCATTGGTGAGGTC
GTCTTTCGTTGGGTAATCCG -> TCTTTCGTTGGGTAATCCGG
GTGACGCTGGGAAGAAAAGC -> TGACGCTGGGAAGAAAAGCT
GTGAGGTCAGAACATAACGT -> TGAGGTCAGAACATAACGTA
GTGCCTCTACTTACTCATAA -> TGCCTCTACTTACTCATAAG
GTGCTACCTGGCAAGAGCGG -> TGCTACCTGGCAAGAGCGGT
GTGGCCTACAAACCCGACGT -> TGGCCTACAAACCCGACGTC
GTGGCGGCAAACTGCTAACC -> TGGCGGCAAACTGCTAACCG
GTGGCGTCTTTCGTTGGGTA -> TGGCGTCTTTCGTTGGGTAA
GTGTTGCACCATTCTACTGT -> TGTTGCACCATTCTACTGTA
GTTAAATCAAGTAGTCATTG -> TTAAATCAAGTAGTCATTGA
GTTAACTTCATGAATGTGAC -> TTAACTTCATGAATGTGACG
GTTAGCGAACCACAGAGCAC -> TTAGCGAACCACAGAGCACT
GTTATTCTAAGATGCCTGAA -> TTATTCTAAGATGCCTGAAT
GTTCGCTGACTGAATGCCCT -> TTCGCTGACTGAATGCCCTT
GTTGCACCATTCTACTGTAG -> TTGCACCATTCTACTGTAGG
GTTGCTTTAAATGACTTCTT -> TTGCTTTAAATGACTTCTTC
GTTGGGTAATCCGGGAGTCC -> TTGGGTAATCCGGGAGTCCC
GTTTACTCGACTCCAAGATC -> TTTACTCGACTCCAAGATCA
GTTTTCGCTGGCGCCACTCG -> TTTTCGCTGGCGCCACTCGT
TAAATCAAGTAGTCATTGAG -> AAATCAAGTAGTCATTGAGG
TAAATGACTTCTTCCGGAGT -> AAATGACTTCTTCCGGAGTT
TAACACCAGACTTAAGCGTT -> AACACCAGACTTAAGCGTTC
TAACACTATTTGTGGCCTAC -> AACACTATTTGTGGCCTACA
TAACAGTGTTGCACCATTCT -> AACAGTGTTGCACCATTCTA
TAACATAACGCTGTATGCTG -> AACATAACGCTGTATGCTGC
TAACCGAGAGGTTATTCTAA -> AACCGAGAGGTTATTCTAAG
TAACGCCCCCAATGTCATGG -> AACGCCCCCAATGTCATGGA
TAACGCTGTATGCTGCAATT -> AACGCTGTATGCTGCAATTG
TAACGTACGGCTCGCGCGGT -> AACGTACGGCTCGCGCGGTC
TAACTTCATGAATGTGACGC -> AACTTCATGAATGTGACGCT
TAAGATGCCTGAATTTCGCC -> AAGATGCCTGAATTTCGCCC
TAAGCGTTCGCTGACTGAAT -> AAGCGTTCGCTGACTGAATG
TAAGGGATATGACTAGTAGA -> AAGGGATATGACTAGTAGAG
TAAGTCCTCGTGGCGTCTTT -> AAGTCCTCGTGGCGTCTTTC
TAATCCGGGAGTCCCATTTT -> AATCCGGGAGTCCCATTTTG
TAATGCACCCTGGATCATGA -> AATGCACCCTGGATCATGAC
TACAAACCCGACGTCATCGC -> ACAAACCCGACGTCATCGCC
TACAGACATGACTTACCTAG -> ACAGACATGACTTACCTAGG
TACCCTAATGCACCCTGGAT -> ACCCTAATGCACCCTGGATC
TACCTAGGAGGGGCGCCCCG -> ACCTAGGAGGGGCGCCCCGG
TACCTGGCAAGAGCGGTATC -> ACCTGGCAAGAGCGGTATCC
TACGACCTAGCGACGTCTTG -> ACGACCTAGCGACGTCTTGC
TACGGCTCGCGCGGTCCTGC -> ACGGCTCGCGCGGTCCTGCC
TACGGTAACACTATTTGTGG -> ACGGTAACACTATTTGTGGC
TACTCATAAGGGATATGACT -> ACTCATAAGGGATATGACTA
TACTCGACTCCAAGATCAGT -> ACTCGACTCCAAGATCAGTC
TACTCTTGGTCTACTGCTGA -> ACTCTTGGTCTACTGCTGAG
TACTGCTGAGAGAGGAGGAC -> ACTGCTGAGAGAGGAGGACA
TACTGTAGGAGTTAACTTCA -> ACTGTAGGAGTTAACTTCAT
TACTTACTCATAAGGGATAT -> ACTTACTCATAAGGGATATG
TACTTGAAGTGCCTCTACTT -> ACTTGAAGTGCCTCTACTTA
TAGACTAGGCACAGCGGTAA -> AGACTAGGCACAGCGGTAAC
TAGAGGTAGGGACTATGGTC -> AGAGGTAGGGACTATGGTCT
TAGCGAACCACAGAGCACTT -> AGCGAACCACAGAGCACTTA
TAGCGACGTCTTGCCCATTG -> AGCGACGTCTTGCCCATTGG
TAGGAGGGGCGCCCCGGCTA -> AGGAGGGGCGCCCCGGCTAA
TAGGAGTTAACTTCATGAAT -> AGGAGTTAACTTCATGAATG
TAGGCACAGCGGTAACATAA -> AGGCACAGCGGTAACATAAC
TAGGCGCAAAATCTCGATGC -> AGGCGCAAAATCTCGATGCA
TAGGGACTATGGTCTCACCT -> AGGGACTATGGTCTCACCTC
TAGTAGAGGTAGGGACTATG -> AGTAGAGGTAGGGACTATGG
TAGTCATTGAGGGAGTATGC -> AGTCATTGAGGGAGTATGCG
TAGTGGCGGCAAACTGCTAA -> AGTGGCGGCAAACTGCTAAC
TATACGGTAACACTATTTGT -> ATACGGTAACACTATTTGTG
TATATATGAACAGCTGGGAC -> ATATATGAACAGCTGGGACA
TATATGAACAGCTGGGACAT -> ATATGAACAGCTGGGACATG
TATATGTCAAAACCCGGAAA -> ATATGTCAAAACCCGGAAAC
TATCCGGAGCTGACCACCCA -> ATCCGGAGCTGACCACCCAT
TATGAACAGCTGGGACATGA -> ATGAACAGCTGGGACATGAT
TATGACGCAAGCTTCCAGCT -> ATGACGCAAGCTTCCAGCTG
TATGACTAGTAGAGGTAGGG -> ATGACTAGTAGAGGTAGGGA
TATGCGGATAGACTAGGCAC -> ATGCGGATAGACTAGGCACA
TATGCTGCAATTGAGCCTGA -> ATGCTGCAATTGAGCCTGAC
TATGGTCTCACCTCTCTGAC -> ATGGTCTCACCTCTCTGACT
TATGTCAAAACCCGGAAACT -> ATGTCAAAACCCGGAAACTC
TATTCTAAGATGCCTGAATT -> ATTCTAAGATGCCTGAATTT
TATTGCTACTTGAAGTGCCT -> ATTGCTACTTGAAGTGCCTC
TATTTGTGGCCTACAAACCC -> ATTTGTGGCCTACAAACCCG
TCAAAACCCGGAAACTCGTA -> CAAAACCCGGAAACTCGTAT
TCAAGATAGGCGCAAAATCT -> CAAGATAGGCGCAAAATCTC
TCAAGTAGTCATTGAGGGAG -> CAAGTAGTCATTGAGGGAGT
TCACCTCTCTGACTTACGAC -> CACCTCTCTGACTTACGACC
TCAGAACATAACGTACGGCT -> CAGAACATAACGTACGGCTC
TCAGTATTGCTACTTGAAGT -> CAGTATTGCTACTTGAAGTG
TCAGTCGGCAAGTCTTCGAT -> CAGTCGGCAAGTCTTCGATC
TCATAAGGGATATGACTAGT -> CATAAGGGATATGACTAGTA
TCATCGCCAGGTCAAGATAG -> CATCGCCAGGTCAAGATAGG
TCATCGTTGCTTTAAATGAC -> CATCGTTGCTTTAAATGACT
TCATGAATGTGACGCTGGGA -> CATGAATGTGACGCTGGGAA
TCATGACAAACATAACAGTG -> CATGACAAACATAACAGTGT
TCATGGATTCTTATATGTCA -> CATGGATTCTTATATGTCAA
TCATTGAGGGAGTATGCGGA -> CATTGAGGGAGTATGCGGAT
TCATTGGTTTTCGCTGGCGC -> CATTGGTTTTCGCTGGCGCC
TCCAAGATCAGTCGGCAAGT -> CCAAGATCAGTCGGCAAGTC
TCCAGCTGCAGCTCGACATC -> CCAGCTGCAGCTCGACATCG
TCCCATTTTGCACCCTACTC -> CCCATTTTGCACCCTACTCT
TCCCCGTATACGGTAACACT -> CCCCGTATACGGTAACACTA
TCCGGAGCTGACCACCCATG -> CCGGAGCTGACCACCCATGC
TCCGGAGTTAGCGAACCACA -> CCGGAGTTAGCGAACCACAG
TCCGGGAGTCCCATTTTGCA -> CCGGGAGTCCCATTTTGCAC
TCCTCGTGGCGTCTTTCGTT -> CCTCGTGGCGTCTTTCGTTG
TCCTGCCAGCGACAATATGA -> CCTGCCAGCGACAATATGAC
TCGAACTTTGGACCCAGTAA -> CGAACTTTGGACCCAGTAAC
TCGACATCGCCAGATTGGGC -> CGACATCGCCAGATTGGGCC
TCGACTCCAAGATCAGTCGG -> CGACTCCAAGATCAGTCGGC
TCGATGCAATGGAGAATAGT -> CGATGCAATGGAGAATAGTG
TCGCCAGATTGGGCCAGCGA -> CGCCAGATTGGGCCAGCGAA
TCGCCAGGTCAAGATAGGCG -> CGCCAGGTCAAGATAGGCGC
TCGCCCCTCGCCTGATTGTG -> CGCCCCTCGCCTGATTGTGC
TCGCCTGATTGTGCTACCTG -> CGCCTGATTGTGCTACCTGG
TCGCGCGGTCCTGCCAGCGA -> CGCGCGGTCCTGCCAGCGAC
TCGCTGACTGAATGCCCTTA -> CGCTGACTGAATGCCCTTAC
TCGCTGGCGCCACTCGTTTA -> CGCTGGCGCCACTCGTTTAC
TCGGCAAGTCTTCGATCGGG -> CGGCAAGTCTTCGATCGGGT
TCGTATATATGAACAGCTGG -> CGTATATATGAACAGCTGGG
TCGTGGCGTCTTTCGTTGGG -> CGTGGCGTCTTTCGTTGGGT
TCGTTGCTTTAAATGACTTC -> CGTTGCTTTAAATGACTTCT
TCGTTGGGTAATCCGGGAGT -> CGTTGGGTAATCCGGGAGTC
TCGTTTACTCGACTCCAAGA -> CGTTTACTCGACTCCAAGAT
TCTAAGATGCCTGAATTTCG -> CTAAGATGCCTGAATTTCGC
TCTACTGCTGAGAGAGGAGG -> CTACTGCTGAGAGAGGAGGA
TCTACTGTAGGAGTTAACTT -> CTACTGTAGGAGTTAACTTC
TCTACTTACTCATAAGGGAT -> CTACTTACTCATAAGGGATA
TCTCACCTCTCTGACTTACG -> CTCACCTCTCTGACTTACGA
TCTCATTGGTTTTCGCTGGC -> CTCATTGGTTTTCGCTGGCG
TCTCGATGCAATGGAGAATA -> CTCGATGCAATGGAGAATAG
TCTCTGACTTACGACCTAGC -> CTCTGACTTACGACCTAGCG
TCTGACTTACGACCTAGCGA -> CTGACTTACGACCTAGCGAC
TCTTATATGTCAAAACCCGG -> CTTATATGTCAAAACCCGGA
TCTTCCGGAGTTAGCGAACC -> CTTCCGGAGTTAGCGAACCA
TCTTGCCCATTGGTGAGGTC -> CTTGCCCATTGGTGAGGTCA
TCTTGGTCTACTGCTGAGAG -> CTTGGTCTACTGCTGAGAGA
TCTTTCGTTGGGTAATCCGG -> CTTTCGTTGGGTAATCCGGG
TGAAAATACAGACATGACTT -> GAAAATACAGACATGACTTA
TGAACAGCTGGGACATGATC -> GAACAGCTGGGACATGATCC
TGAAGTGCCTCTACTTACTC -> GAAGTGCCTCTACTTACTCA
TGAATGCCCTTACCCTAATG -> GAATGCCCTTACCCTAATGC
TGAATGTGACGCTGGGAAGA -> GAATGTGACGCTGGGAAGAA
TGAATTTCGCCCCTCGCCTG -> GAATTTCGCCCCTCGCCTGA
TGACAAACATAACAGTGTTG -> GACAAACATAACAGTGTTGC
TGACCACCCATGCACCCATC -> GACCACCCATGCACCCATCA
TGACGCAAGCTTCCAGCTGC -> GACGCAAGCTTCCAGCTGCA
TGACGCATTCGAACTTTGGA -> GACGCATTCGAACTTTGGAC
TGACGCTGGGAAGAAAAGCT -> GACGCTGGGAAGAAAAGCTG
TGACTAGTAGAGGTAGGGAC -> GACTAGTAGAGGTAGGGACT
TGACTGAATGCCCTTACCCT -> GACTGAATGCCCTTACCCTA
TGACTTACCTAGGAGGGGCG -> GACTTACCTAGGAGGGGCGC
TGACTTACGACCTAGCGACG -> GACTTACGACCTAGCGACGT
TGACTTCTTCCGGAGTTAGC -> GACTTCTTCCGGAGTTAGCG
TGAGAGAGGAGGACAAGTTA -> GAGAGAGGAGGACAAGTTAA
TGAGCCTGACGCATTCGAAC -> GAGCCTGACGCATTCGAACT
TGAGGGAGTATGCGGATAGA -> GAGGGAGTATGCGGATAGAC
TGAGGTCAGAACATAACGTA -> GAGGTCAGAACATAACGTAC
TGATCCCCGTATACGGTAAC -> GATCCCCGTATACGGTAACA
TGATTGTGCTACCTGGCAAG -> GATTGTGCTACCTGGCAAGA
TGCAATGGAGAATAGTGGCG -> GCAATGGAGAATAGTGGCGG
TGCAATTGAGCCTGACGCAT -> GCAATTGAGCCTGACGCATT
TGCACCATTCTACTGTAGGA -> GCACCATTCTACTGTAGGAG
TGCACCCATCAGTATTGCTA -> GCACCCATCAGTATTGCTAC
TGCACCCTACTCTTGGTCTA -> GCACCCTACTCTTGGTCTAC
TGCACCCTGGATCATGACAA -> GCACCCTGGATCATGACAAA
TGCAGCTCGACATCGCCAGA -> GCAGCTCGACATCGCCAGAT
TGCCAGCGACAATATGACGC -> GCCAGCGACAATATGACGCA
TGCCCATTGGTGAGGTCAGA -> GCCCATTGGTGAGGTCAGAA
TGCCCTTACCCTAATGCACC -> GCCCTTACCCTAATGCACCC
TGCCTCTACTTACTCATAAG -> GCCTCTACTTACTCATAAGG
TGCCTGAATTTCGCCCCTCG -> GCCTGAATTTCGCCCCTCGC
TGCGGATAGACTAGGCACAG -> GCGGATAGACTAGGCACAGC
TGCTAACCGAGAGGTTATTC -> GCTAACCGAGAGGTTATTCT
TGCTACCTGGCAAGAGCGGT -> GCTACCTGGCAAGAGCGGTA
TGCTACTTGAAGTGCCTCTA -> GCTACTTGAAGTGCCTCTAC
TGCTGAGAGAGGAGGACAAG -> GCTGAGAGAGGAGGACAAGT
TGCTGCAATTGAGCCTGACG -> GCTGCAATTGAGCCTGACGC
TGCTTTAAATGACTTCTTCC -> GCTTTAAATGACTTCTTCCG
TGGACCCAGTAACACCAGAC -> GGACCCAGTAACACCAGACT
TGGAGAATAGTGGCGGCAAA -> GGAGAATAGTGGCGGCAAAC
TGGATCATGACAAACATAAC -> GGATCATGACAAACATAACA
TGGATCTCATTGGTTTTCGC -> GGATCTCATTGGTTTTCGCT
TGGATTCTTATATGTCAAAA -> GGATTCTTATATGTCAAAAC
TGGCAAGAGCGGTATCCGGA -> GGCAAGAGCGGTATCCGGAG
TGGCCTACAAACCCGACGTC -> GGCCTACAAACCCGACGTCA
TGGCGCCACTCGTTTACTCG -> GGCGCCACTCGTTTACTCGA
TGGCGGCAAACTGCTAACCG -> GGCGGCAAACTGCTAACCGA
TGGCGTCTTTCGTTGGGTAA -> GGCGTCTTTCGTTGGGTAAT
TGGGAAGAAAAGCTGAAAAT -> GGGAAGAAAAGCTGAAAATA
TGGGACATGATCCCCGTATA -> GGGACATGATCCCCGTATAC
TGGGCCAGCGAACGGCGGCA -> GGGCCAGCGAACGGCGGCAT
TGGGTAATCCGGGAGTCCCA -> GGGTAATCCGGGAGTCCCAT
TGGTCTACTGCTGAGAGAGG -> GGTCTACTGCTGAGAGAGGA
TGGTCTCACCTCTCTGACTT -> GGTCTCACCTCTCTGACTTA
TGGTGAGGTCAGAACATAAC -> GGTGAGGTCAGAACATAACG
TGGTTTTCGCTGGCGCCACT -> GGTTTTCGCTGGCGCCACTC
TGTAGGAGTTAACTTCATGA -> GTAGGAGTTAACTTCATGAA
TGTATGCTGCAATTGAGCCT -> GTATGCTGCAATTGAGCCTG
TGTCAAAACCCGGAAACTCG -> GTCAAAACCCGGAAACTCGT
TGTCATGGATTCTTATATGT -> GTCATGGATTCTTATATGTC
TGTGACGCTGGGAAGAAAAG -> GTGACGCTGGGAAGAAAAGC
TGTGCTACCTGGCAAGAGCG -> GTGCTACCTGGCAAGAGCGG
TGTGGCCTACAAACCCGACG -> GTGGCCTACAAACCCGACGT
TGTTGCACCATTCTACTGTA -> GTTGCACCATTCTACTGTAG
TTAAATCAAGTAGTCATTGA -> TAAATCAAGTAGTCATTGAG
TTAAATGACTTCTTCCGGAG -> TAAATGACTTCTTCCGGAGT
TTAACTTCATGAATGTGACG -> TAACTTCATGAATGTGACGC
TTAAGCGTTCGCTGACTGAA -> TAAGCGTTCGCTGACTGAAT
TTAAGTCCTCGTGGCGTCTT -> TAAGTCCTCGTGGCGTCTTT
TTACCCTAATGCACCCTGGA -> TACCCTAATGCACCCTGGAT
TTACCTAGGAGGGGCGCCCC -> TACCTAGGAGGGGCGCCCCG
TTACGACCTAGCGACGTCTT -> TACGACCTAGCGACGTCTTG
TTACTCATAAGGGATATGAC -> TACTCATAAGGGATATGACT
TTACTCGACTCCAAGATCAG -> TACTCGACTCCAAGATCAGT
TTAGCGAACCACAGAGCACT -> TAGCGAACCACAGAGCACTT
TTATATGTCAAAACCCGGAA -> TATATGTCAAAACCCGGAAA
TTATTCTAAGATGCCTGAAT -> TATTCTAAGATGCCTGAATT
TTCATCGTTGCTTTAAATGA -> TCATCGTTGCTTTAAATGAC
TTCATGAATGTGACGCTGGG -> TCATGAATGTGACGCTGGGA
TTCCAGCTGCAGCTCGACAT -> TCCAGCTGCAGCTCGACATC
TTCCGGAGTTAGCGAACCAC -> TCCGGAGTTAGCGAACCACA
TTCGAACTTTGGACCCAGTA -> TCGAACTTTGGACCCAGTAA
TTCGCCCCTCGCCTGATTGT -> TCGCCCCTCGCCTGATTGTG
TTCGCTGACTGAATGCCCTT -> TCGCTGACTGAATGCCCTTA
TTCGCTGGCGCCACTCGTTT -> TCGCTGGCGCCACTCGTTTA
TTCGTTGGGTAATCCGGGAG -> TCGTTGGGTAATCCGGGAGT
TTCTAAGATGCCTGAATTTC -> TCTAAGATGCCTGAATTTCG
TTCTACTGTAGGAGTTAACT -> TCTACTGTAGGAGTTAACTT
TTCTTATATGTCAAAACCCG -> TCTTATATGTCAAAACCCGG
TTCTTCCGGAGTTAGCGAAC -> TCTTCCGGAGTTAGCGAACC
TTGAAGTGCCTCTACTTACT -> TGAAGTGCCTCTACTTACTC
TTGAGCCTGACGCATTCGAA -> TGAGCCTGACGCATTCGAAC
TTGAGGGAGTATGCGGATAG -> TGAGGGAGTATGCGGATAGA
TTGCACCATTCTACTGTAGG -> TGCACCATTCTACTGTAGGA
TTGCACCCTACTCTTGGTCT -> TGCACCCTACTCTTGGTCTA
TTGCCCATTGGTGAGGTCAG -> TGCCCATTGGTGAGGTCAGA
TTGCTACTTGAAGTGCCTCT -> TGCTACTTGAAGTGCCTCTA
TTGCTTTAAATGACTTCTTC -> TGCTTTAAATGACTTCTTCC
TTGGACCCAGTAACACCAGA -> TGGACCCAGTAACACCAGAC
TTGGGCCAGCGAACGGCGGC -> TGGGCCAGCGAACGGCGGCA
TTGGGTAATCCGGGAGTCCC -> TGGGTAATCCGGGAGTCCCA
TTGGTCTACTGCTGAGAGAG -> TGGTCTACTGCTGAGAGAGG
TTGGTGAGGTCAGAACATAA -> TGGTGAGGTCAGAACATAAC
TTGGTTTTCGCTGGCGCCAC -> TGGTTTTCGCTGGCGCCACT
TTGTGCTACCTGGCAAGAGC -> TGTGCTACCTGGCAAGAGCG
TTGTGGCCTACAAACCCGAC -> TGTGGCCTACAAACCCGACG
TTTAAATGACTTCTTCCGGA -> TTAAATGACTTCTTCCGGAG
TTTACTCGACTCCAAGATCA -> TTACTCGACTCCAAGATCAG
TTTCATCGTTGCTTTAAATG -> TTCATCGTTGCTTTAAATGA
TTTCGCCCCTCGCCTGATTG -> TTCGCCCCTCGCCTGATTGT
TTTCGCTGGCGCCACTCGTT -> TTCGCTGGCGCCACTCGTTT
TTTCGTTGGGTAATCCGGGA -> TTCGTTGGGTAATCCGGGAG
TTTGCACCCTACTCTTGGTC -> TTGCACCCTACTCTTGGTCT
TTTGGACCCAGTAACACCAG -> TTGGACCCAGTAACACCAGA
TTTGTGGCCTACAAACCCGA -> TTGTGGCCTACAAACCCGAC
TTTTCATCGTTGCTTTAAAT -> TTTCATCGTTGCTTTAAATG
TTTTCGCTGGCGCCACTCGT -> TTTCGCTGGCGCCACTCGTT
TTTTGCACCCTACTCTTGGT -> TTTGCACCCTACTCTTGGTC
